"Player","Squad","Season","Nation","Pos","Age","Born","Mins_Per_90","Tkl_Tackles","TklW_Tackles","Def 3rd_Tackles","Mid 3rd_Tackles","Att 3rd_Tackles","Tkl_Challenges","Att_Challenges","Tkl_percent_Challenges","Lost_Challenges","Blocks_Blocks","Sh_Blocks","Pass_Blocks","Int","Tkl+Int","Clr","Err","Matches","url"
"Patrick van Aanholt","Crystal Palace",2021,"nl NED","DF",29,1990,19.7,35,22,18,17,0,19,43,44.2,24,18,6,12,30,65,40,2,"Matches","https://fbref.com/en/comps/9/2020-2021/defense/2020-2021-Premier-League-Stats"
"Tammy Abraham","Chelsea",2021,"eng ENG","FW",22,1997,11.6,7,5,3,3,1,1,7,14.3,6,6,0,6,5,12,17,0,"Matches","https://fbref.com/en/comps/9/2020-2021/defense/2020-2021-Premier-League-Stats"
"Che Adams","Southampton",2021,"sct SCO","FW",24,1996,29.6,25,16,4,15,6,6,17,35.3,11,20,2,18,4,29,19,1,"Matches","https://fbref.com/en/comps/9/2020-2021/defense/2020-2021-Premier-League-Stats"
"Tosin Adarabioyo","Fulham",2021,"eng ENG","DF",22,1997,32.8,37,19,30,6,1,19,40,47.5,21,26,20,6,42,79,197,2,"Matches","https://fbref.com/en/comps/9/2020-2021/defense/2020-2021-Premier-League-Stats"
"Adrián","Liverpool",2021,"es ESP","GK",33,1987,3,0,0,0,0,0,0,0,NA,0,0,0,0,0,0,3,1,"Matches","https://fbref.com/en/comps/9/2020-2021/defense/2020-2021-Premier-League-Stats"
"Sergio Agüero","Manchester City",2021,"ar ARG","FW",32,1988,6.2,4,1,0,2,2,2,11,18.2,9,2,0,2,2,6,0,0,"Matches","https://fbref.com/en/comps/9/2020-2021/defense/2020-2021-Premier-League-Stats"
"Ola Aina","Fulham",2021,"ng NGA","DF",23,1996,29.6,37,20,22,7,8,21,43,48.8,22,22,6,16,45,82,94,2,"Matches","https://fbref.com/en/comps/9/2020-2021/defense/2020-2021-Premier-League-Stats"
"Rayan Aït Nouri","Wolves",2021,"dz ALG","DF",19,2001,15.6,29,16,18,10,1,13,27,48.1,14,14,1,13,15,44,25,0,"Matches","https://fbref.com/en/comps/9/2020-2021/defense/2020-2021-Premier-League-Stats"
"Semi Ajayi","West Brom",2021,"ng NGA","DF",26,1993,30.9,40,14,34,6,0,23,41,56.1,18,51,32,19,42,82,122,2,"Matches","https://fbref.com/en/comps/9/2020-2021/defense/2020-2021-Premier-League-Stats"
"Nathan Aké","Manchester City",2021,"nl NED","DF",25,1995,8.9,10,5,3,6,1,3,4,75,1,2,1,1,9,19,23,0,"Matches","https://fbref.com/en/comps/9/2020-2021/defense/2020-2021-Premier-League-Stats"
"Marc Albrighton","Leicester City",2021,"eng ENG","DF,FW",30,1989,19.4,33,19,14,15,4,16,45,35.6,29,29,3,26,17,50,27,1,"Matches","https://fbref.com/en/comps/9/2020-2021/defense/2020-2021-Premier-League-Stats"
"Thiago Alcántara","Liverpool",2021,"es ESP","MF",29,1991,20.6,61,36,20,30,11,17,49,34.7,32,26,0,26,30,91,14,0,"Matches","https://fbref.com/en/comps/9/2020-2021/defense/2020-2021-Premier-League-Stats"
"Toby Alderweireld","Tottenham",2021,"be BEL","DF",31,1989,24.9,35,22,22,11,2,18,30,60,12,40,28,12,10,45,121,0,"Matches","https://fbref.com/en/comps/9/2020-2021/defense/2020-2021-Premier-League-Stats"
"Rúnar Alex Rúnarsson","Arsenal",2021,"is ISL","GK",25,1995,0.2,0,0,0,0,0,0,0,NA,0,0,0,0,0,0,0,0,"Matches","https://fbref.com/en/comps/9/2020-2021/defense/2020-2021-Premier-League-Stats"
"Trent Alexander-Arnold","Liverpool",2021,"eng ENG","DF",21,1998,33.7,56,33,31,18,7,36,56,64.3,20,24,3,21,49,105,50,3,"Matches","https://fbref.com/en/comps/9/2020-2021/defense/2020-2021-Premier-League-Stats"
"Ezgjan Alioski","Leeds United",2021,"mk MKD","DF,MF",28,1992,27.3,74,31,38,28,8,32,74,43.2,42,17,2,15,23,97,50,2,"Matches","https://fbref.com/en/comps/9/2020-2021/defense/2020-2021-Premier-League-Stats"
"Alisson","Liverpool",2021,"br BRA","GK",27,1992,33,3,2,3,0,0,3,4,75,1,0,0,0,2,5,26,7,"Matches","https://fbref.com/en/comps/9/2020-2021/defense/2020-2021-Premier-League-Stats"
"Allan","Everton",2021,"br BRA","MF",29,1991,22.8,80,45,39,37,4,28,95,29.5,67,31,12,19,19,99,25,1,"Matches","https://fbref.com/en/comps/9/2020-2021/defense/2020-2021-Premier-League-Stats"
"Dele Alli","Tottenham",2021,"eng ENG","MF",24,1996,6.9,18,11,8,6,4,7,19,36.8,12,9,0,9,7,25,3,0,"Matches","https://fbref.com/en/comps/9/2020-2021/defense/2020-2021-Premier-League-Stats"
"Miguel Almirón","Newcastle Utd",2021,"py PAR","MF,FW",26,1994,27,49,29,21,25,3,14,56,25,42,23,4,19,25,74,20,1,"Matches","https://fbref.com/en/comps/9/2020-2021/defense/2020-2021-Premier-League-Stats"
"Marcos Alonso","Chelsea",2021,"es ESP","DF",29,1990,10.7,13,3,6,4,3,7,14,50,7,12,1,11,12,25,30,0,"Matches","https://fbref.com/en/comps/9/2020-2021/defense/2020-2021-Premier-League-Stats"
"Steven Alzate","Brighton",2021,"co COL","MF",21,1998,10,17,8,10,4,3,6,15,40,9,8,1,7,8,25,10,0,"Matches","https://fbref.com/en/comps/9/2020-2021/defense/2020-2021-Premier-League-Stats"
"Daniel Amartey","Leicester City",2021,"gh GHA","DF",25,1994,8,11,7,6,4,1,8,12,66.7,4,8,4,4,12,23,26,0,"Matches","https://fbref.com/en/comps/9/2020-2021/defense/2020-2021-Premier-League-Stats"
"Ethan Ampadu","Sheffield Utd",2021,"wls WAL","DF,MF",19,2000,23.2,57,36,31,24,2,20,46,43.5,26,40,19,21,49,106,87,3,"Matches","https://fbref.com/en/comps/9/2020-2021/defense/2020-2021-Premier-League-Stats"
"Joachim Andersen","Fulham",2021,"dk DEN","DF",24,1996,30.3,33,19,18,11,4,15,28,53.6,13,24,13,11,44,77,151,1,"Matches","https://fbref.com/en/comps/9/2020-2021/defense/2020-2021-Premier-League-Stats"
"Elliot Anderson","Newcastle Utd",2021,"sct SCO","MF",17,2002,0,0,0,0,0,0,0,0,NA,0,0,0,0,0,0,0,0,"Matches","https://fbref.com/en/comps/9/2020-2021/defense/2020-2021-Premier-League-Stats"
"Felipe Anderson","West Ham",2021,"br BRA","FW,MF",27,1993,0,1,1,0,1,0,0,0,NA,0,0,0,0,0,1,0,0,"Matches","https://fbref.com/en/comps/9/2020-2021/defense/2020-2021-Premier-League-Stats"
"Michail Antonio","West Ham",2021,"jm JAM","FW",30,1990,21.9,7,4,1,5,1,1,7,14.3,6,20,3,17,7,14,7,0,"Matches","https://fbref.com/en/comps/9/2020-2021/defense/2020-2021-Premier-League-Stats"
"Alphonse Areola","Fulham",2021,"fr FRA","GK",27,1993,36,1,0,1,0,0,1,5,20,4,0,0,0,1,2,13,3,"Matches","https://fbref.com/en/comps/9/2020-2021/defense/2020-2021-Premier-League-Stats"
"Stuart Armstrong","Southampton",2021,"sct SCO","MF",28,1992,30.7,60,41,19,32,9,27,75,36,48,26,1,25,24,84,19,0,"Matches","https://fbref.com/en/comps/9/2020-2021/defense/2020-2021-Premier-League-Stats"
"Kepa Arrizabalaga","Chelsea",2021,"es ESP","GK",25,1994,6.5,0,0,0,0,0,0,1,0,1,0,0,0,0,0,0,3,"Matches","https://fbref.com/en/comps/9/2020-2021/defense/2020-2021-Premier-League-Stats"
"Pierre-Emerick Aubameyang","Arsenal",2021,"ga GAB","FW",31,1989,25.9,12,8,7,4,1,3,20,15,17,18,0,18,7,19,17,0,"Matches","https://fbref.com/en/comps/9/2020-2021/defense/2020-2021-Premier-League-Stats"
"Serge Aurier","Tottenham",2021,"ci CIV","DF",27,1992,17.8,55,33,33,17,5,15,40,37.5,25,28,5,23,19,74,44,3,"Matches","https://fbref.com/en/comps/9/2020-2021/defense/2020-2021-Premier-League-Stats"
"Charlie Austin","West Brom",2021,"eng ENG","FW,MF",31,1989,1.5,4,2,1,2,1,1,3,33.3,2,0,0,0,3,7,4,0,"Matches","https://fbref.com/en/comps/9/2020-2021/defense/2020-2021-Premier-League-Stats"
"Jordan Ayew","Crystal Palace",2021,"gh GHA","FW,MF",28,1991,23.3,38,26,8,16,14,16,44,36.4,28,28,2,26,16,54,12,0,"Matches","https://fbref.com/en/comps/9/2020-2021/defense/2020-2021-Premier-League-Stats"
"Luke Ayling","Leeds United",2021,"eng ENG","DF",28,1991,37.8,108,61,69,30,9,49,87,56.3,38,53,36,17,36,144,96,5,"Matches","https://fbref.com/en/comps/9/2020-2021/defense/2020-2021-Premier-League-Stats"
"César Azpilicueta","Chelsea",2021,"es ESP","DF",30,1989,24.3,53,28,22,24,7,19,37,51.4,18,30,5,25,28,81,62,2,"Matches","https://fbref.com/en/comps/9/2020-2021/defense/2020-2021-Premier-League-Stats"
"Eric Bailly","Manchester Utd",2021,"ci CIV","DF",26,1994,10.2,5,5,3,1,1,0,1,0,1,13,11,2,13,18,36,2,"Matches","https://fbref.com/en/comps/9/2020-2021/defense/2020-2021-Premier-League-Stats"
"Fabián Balbuena","West Ham",2021,"py PAR","DF",28,1991,13.3,24,12,23,1,0,14,23,60.9,9,23,6,17,25,49,63,0,"Matches","https://fbref.com/en/comps/9/2020-2021/defense/2020-2021-Premier-League-Stats"
"George Baldock","Sheffield Utd",2021,"gr GRE","DF",27,1993,31,47,34,28,14,5,21,50,42,29,26,7,19,25,72,70,1,"Matches","https://fbref.com/en/comps/9/2020-2021/defense/2020-2021-Premier-League-Stats"
"Gareth Bale","Tottenham",2021,"wls WAL","FW",31,1989,10.2,17,10,4,9,4,7,14,50,7,13,2,11,8,25,16,0,"Matches","https://fbref.com/en/comps/9/2020-2021/defense/2020-2021-Premier-League-Stats"
"Patrick Bamford","Leeds United",2021,"eng ENG","FW",26,1993,33.9,21,9,2,11,8,8,27,29.6,19,14,4,10,10,31,37,0,"Matches","https://fbref.com/en/comps/9/2020-2021/defense/2020-2021-Premier-League-Stats"
"Phil Bardsley","Burnley",2021,"sct SCO","DF",35,1985,3,6,5,4,2,0,3,6,50,3,3,1,2,6,12,12,0,"Matches","https://fbref.com/en/comps/9/2020-2021/defense/2020-2021-Premier-League-Stats"
"Ross Barkley","Aston Villa",2021,"eng ENG","MF",26,1993,17,6,2,2,4,0,3,15,20,12,9,1,8,5,11,6,1,"Matches","https://fbref.com/en/comps/9/2020-2021/defense/2020-2021-Premier-League-Stats"
"Ross Barkley","Chelsea",2021,"eng ENG","FW,MF",26,1993,0.5,0,0,0,0,0,0,0,NA,0,0,0,0,0,0,0,0,"Matches","https://fbref.com/en/comps/9/2020-2021/defense/2020-2021-Premier-League-Stats"
"Ashley Barnes","Burnley",2021,"eng ENG","FW",30,1989,14.8,12,6,2,6,4,3,13,23.1,10,14,2,12,5,17,11,0,"Matches","https://fbref.com/en/comps/9/2020-2021/defense/2020-2021-Premier-League-Stats"
"Harvey Barnes","Leicester City",2021,"eng ENG","FW,MF",22,1997,21.6,19,9,11,3,5,5,22,22.7,17,16,3,13,8,27,11,0,"Matches","https://fbref.com/en/comps/9/2020-2021/defense/2020-2021-Premier-League-Stats"
"Kyle Bartley","West Brom",2021,"eng ENG","DF",29,1991,28.7,27,16,14,10,3,11,23,47.8,12,50,35,15,38,65,159,1,"Matches","https://fbref.com/en/comps/9/2020-2021/defense/2020-2021-Premier-League-Stats"
"Chris Basham","Sheffield Utd",2021,"eng ENG","DF,MF",32,1988,28.6,69,42,41,23,5,41,67,61.2,26,36,15,21,49,118,105,1,"Matches","https://fbref.com/en/comps/9/2020-2021/defense/2020-2021-Premier-League-Stats"
"Michy Batshuayi","Crystal Palace",2021,"be BEL","FW",26,1993,8.1,5,3,1,2,2,1,9,11.1,8,5,1,4,4,9,5,0,"Matches","https://fbref.com/en/comps/9/2020-2021/defense/2020-2021-Premier-League-Stats"
"Jan Bednarek","Southampton",2021,"pl POL","DF",24,1996,34.4,37,19,25,11,1,25,49,51,24,44,27,17,84,121,132,0,"Matches","https://fbref.com/en/comps/9/2020-2021/defense/2020-2021-Premier-League-Stats"
"Donny van de Beek","Manchester Utd",2021,"nl NED","MF,FW",23,1997,5.8,15,10,2,11,2,7,15,46.7,8,10,1,9,6,21,7,0,"Matches","https://fbref.com/en/comps/9/2020-2021/defense/2020-2021-Premier-League-Stats"
"Héctor Bellerín","Arsenal",2021,"es ESP","DF,MF",25,1995,23.2,29,19,14,12,3,12,41,29.3,29,26,8,18,33,62,33,0,"Matches","https://fbref.com/en/comps/9/2020-2021/defense/2020-2021-Premier-League-Stats"
"Saïd Benrahma","West Ham",2021,"dz ALG","FW,MF",24,1995,15.5,24,15,8,11,5,8,28,28.6,20,10,0,10,8,32,8,0,"Matches","https://fbref.com/en/comps/9/2020-2021/defense/2020-2021-Premier-League-Stats"
"Josh Benson","Burnley",2021,"eng ENG","MF",20,1999,2.9,5,1,3,0,2,1,6,16.7,5,3,0,3,3,8,2,0,"Matches","https://fbref.com/en/comps/9/2020-2021/defense/2020-2021-Premier-League-Stats"
"Christian Benteke","Crystal Palace",2021,"be BEL","FW",29,1990,20.2,15,7,1,7,7,2,9,22.2,7,17,6,11,4,19,39,0,"Matches","https://fbref.com/en/comps/9/2020-2021/defense/2020-2021-Premier-League-Stats"
"Gaetano Berardi","Leeds United",2021,"ch SUI","DF",31,1988,1.3,2,2,1,0,1,0,0,NA,0,2,1,1,1,3,2,0,"Matches","https://fbref.com/en/comps/9/2020-2021/defense/2020-2021-Premier-League-Stats"
"Jóhann Berg Guðmundsson","Burnley",2021,"is ISL","MF",29,1990,15.1,19,11,6,9,4,11,23,47.8,12,11,2,9,17,36,19,0,"Matches","https://fbref.com/en/comps/9/2020-2021/defense/2020-2021-Premier-League-Stats"
"Sander Berge","Sheffield Utd",2021,"no NOR","MF",22,1998,12.4,16,7,8,5,3,7,15,46.7,8,11,2,9,4,20,18,0,"Matches","https://fbref.com/en/comps/9/2020-2021/defense/2020-2021-Premier-League-Stats"
"Steven Bergwijn","Tottenham",2021,"nl NED","FW,MF",22,1997,13.4,15,7,8,3,4,7,20,35,13,7,1,6,5,20,9,0,"Matches","https://fbref.com/en/comps/9/2020-2021/defense/2020-2021-Premier-League-Stats"
"Bernard","Everton",2021,"br BRA","MF,FW",27,1992,5.1,8,3,3,3,2,7,15,46.7,8,5,0,5,8,16,6,0,"Matches","https://fbref.com/en/comps/9/2020-2021/defense/2020-2021-Premier-League-Stats"
"Bernardo","Brighton",2021,"br BRA","DF,MF",25,1995,2.3,10,8,8,1,1,4,6,66.7,2,2,0,2,1,11,1,0,"Matches","https://fbref.com/en/comps/9/2020-2021/defense/2020-2021-Premier-League-Stats"
"Ryan Bertrand","Southampton",2021,"eng ENG","DF",30,1989,28.9,60,32,26,27,7,30,48,62.5,18,19,1,18,30,90,41,1,"Matches","https://fbref.com/en/comps/9/2020-2021/defense/2020-2021-Premier-League-Stats"
"Yves Bissouma","Brighton",2021,"ml MLI","MF",23,1996,34.6,104,68,50,48,6,33,67,49.3,34,42,6,36,64,168,67,0,"Matches","https://fbref.com/en/comps/9/2020-2021/defense/2020-2021-Premier-League-Stats"
"Jayden Bogle","Sheffield Utd",2021,"eng ENG","DF,MF",20,2000,12.3,33,23,21,10,2,20,39,51.3,19,14,4,10,14,47,22,0,"Matches","https://fbref.com/en/comps/9/2020-2021/defense/2020-2021-Premier-League-Stats"
"Willy Boly","Wolves",2021,"ci CIV","DF",29,1991,20.9,33,20,26,7,0,13,24,54.2,11,18,12,6,32,65,84,1,"Matches","https://fbref.com/en/comps/9/2020-2021/defense/2020-2021-Premier-League-Stats"
"Jarrod Bowen","West Ham",2021,"eng ENG","FW,MF",23,1996,28.5,26,15,12,7,7,10,29,34.5,19,19,1,18,22,48,10,0,"Matches","https://fbref.com/en/comps/9/2020-2021/defense/2020-2021-Premier-League-Stats"
"Robbie Brady","Burnley",2021,"ie IRL","MF",28,1992,11.7,22,15,12,6,4,12,35,34.3,23,16,0,16,9,31,29,1,"Matches","https://fbref.com/en/comps/9/2020-2021/defense/2020-2021-Premier-League-Stats"
"Rhian Brewster","Sheffield Utd",2021,"eng ENG","FW,MF",20,2000,12.5,8,5,1,4,3,1,13,7.7,12,15,2,13,5,13,5,0,"Matches","https://fbref.com/en/comps/9/2020-2021/defense/2020-2021-Premier-League-Stats"
"Nathan Broadhead","Everton",2021,"wls WAL","FW",22,1998,0,1,1,0,1,0,0,0,NA,0,0,0,0,0,1,0,0,"Matches","https://fbref.com/en/comps/9/2020-2021/defense/2020-2021-Premier-League-Stats"
"Josh Brownhill","Burnley",2021,"eng ENG","MF",24,1995,31.3,45,27,9,29,7,15,44,34.1,29,33,11,22,69,114,39,0,"Matches","https://fbref.com/en/comps/9/2020-2021/defense/2020-2021-Premier-League-Stats"
"Joe Bryan","Fulham",2021,"eng ENG","DF,MF",26,1993,7.4,15,8,7,5,3,7,12,58.3,5,8,2,6,14,29,16,0,"Matches","https://fbref.com/en/comps/9/2020-2021/defense/2020-2021-Premier-League-Stats"
"Kean Bryan","Sheffield Utd",2021,"eng ENG","DF",23,1996,11.2,20,10,9,11,0,9,19,47.4,10,16,10,6,13,33,39,1,"Matches","https://fbref.com/en/comps/9/2020-2021/defense/2020-2021-Premier-League-Stats"
"Oliver Burke","Sheffield Utd",2021,"sct SCO","FW",23,1997,14.1,16,8,6,9,1,5,24,20.8,19,24,0,24,2,18,6,0,"Matches","https://fbref.com/en/comps/9/2020-2021/defense/2020-2021-Premier-League-Stats"
"Dan Burn","Brighton",2021,"eng ENG","DF",28,1992,22.9,50,26,33,14,3,27,53,50.9,26,30,7,23,31,81,75,0,"Matches","https://fbref.com/en/comps/9/2020-2021/defense/2020-2021-Premier-League-Stats"
"Jack Butland","Crystal Palace",2021,"eng ENG","GK",27,1993,1,0,0,0,0,0,0,0,NA,0,0,0,0,0,0,0,0,"Matches","https://fbref.com/en/comps/9/2020-2021/defense/2020-2021-Premier-League-Stats"
"David Button","West Brom",2021,"eng ENG","GK",31,1989,1,0,0,0,0,0,0,0,NA,0,0,0,0,0,0,0,0,"Matches","https://fbref.com/en/comps/9/2020-2021/defense/2020-2021-Premier-League-Stats"
"Oskar Buur","Wolves",2021,"dk DEN","DF",22,1998,0.2,0,0,0,0,0,0,2,0,2,0,0,0,0,0,0,0,"Matches","https://fbref.com/en/comps/9/2020-2021/defense/2020-2021-Premier-League-Stats"
"Willy Caballero","Chelsea",2021,"ar ARG","GK",38,1981,1,0,0,0,0,0,0,0,NA,0,0,0,0,0,0,0,0,"Matches","https://fbref.com/en/comps/9/2020-2021/defense/2020-2021-Premier-League-Stats"
"Gary Cahill","Crystal Palace",2021,"eng ENG","DF",34,1985,20,13,9,10,3,0,7,11,63.6,4,27,22,5,13,26,88,0,"Matches","https://fbref.com/en/comps/9/2020-2021/defense/2020-2021-Premier-League-Stats"
"Tom Cairney","Fulham",2021,"sct SCO","MF",29,1991,8.4,9,3,1,4,4,1,4,25,3,6,0,6,0,9,3,0,"Matches","https://fbref.com/en/comps/9/2020-2021/defense/2020-2021-Premier-League-Stats"
"Dominic Calvert-Lewin","Everton",2021,"eng ENG","FW",23,1997,31.9,17,8,1,8,8,6,12,50,6,22,6,16,6,23,33,0,"Matches","https://fbref.com/en/comps/9/2020-2021/defense/2020-2021-Premier-League-Stats"
"João Cancelo","Manchester City",2021,"pt POR","DF,MF",26,1994,25.5,68,41,42,19,7,43,83,51.8,40,23,2,21,41,109,33,2,"Matches","https://fbref.com/en/comps/9/2020-2021/defense/2020-2021-Premier-League-Stats"
"Ian Carlo Poveda","Leeds United",2021,"eng ENG","MF",20,2000,3.9,5,4,3,0,2,1,7,14.3,6,5,1,4,1,6,2,0,"Matches","https://fbref.com/en/comps/9/2020-2021/defense/2020-2021-Premier-League-Stats"
"Andy Carroll","Newcastle Utd",2021,"eng ENG","FW",31,1989,4.4,3,1,1,1,1,1,8,12.5,7,1,0,1,0,3,14,0,"Matches","https://fbref.com/en/comps/9/2020-2021/defense/2020-2021-Premier-League-Stats"
"Scott Carson","Manchester City",2021,"eng ENG","GK",34,1985,1,0,0,0,0,0,0,0,NA,0,0,0,0,0,0,0,0,"Matches","https://fbref.com/en/comps/9/2020-2021/defense/2020-2021-Premier-League-Stats"
"Fabio Carvalho","Fulham",2021,"pt POR","MF,FW",17,2002,2.8,9,6,4,4,1,5,9,55.6,4,2,0,2,1,10,1,1,"Matches","https://fbref.com/en/comps/9/2020-2021/defense/2020-2021-Premier-League-Stats"
"Matty Cash","Aston Villa",2021,"pl POL","DF",22,1997,26.4,71,40,43,22,6,41,74,55.4,33,50,11,39,60,131,95,0,"Matches","https://fbref.com/en/comps/9/2020-2021/defense/2020-2021-Premier-League-Stats"
"Kiko Casilla","Leeds United",2021,"es ESP","GK",33,1986,3,0,0,0,0,0,0,0,NA,0,0,0,0,0,0,0,0,"Matches","https://fbref.com/en/comps/9/2020-2021/defense/2020-2021-Premier-League-Stats"
"Timothy Castagne","Leicester City",2021,"be BEL","DF",24,1995,26.1,52,32,29,18,5,24,44,54.5,20,29,5,24,29,81,62,1,"Matches","https://fbref.com/en/comps/9/2020-2021/defense/2020-2021-Premier-League-Stats"
"Jonny Castro","Wolves",2021,"es ESP","MF,DF",26,1994,5.5,11,5,6,4,1,6,13,46.2,7,9,3,6,9,20,7,0,"Matches","https://fbref.com/en/comps/9/2020-2021/defense/2020-2021-Premier-League-Stats"
"Ivan Cavaleiro","Fulham",2021,"pt POR","FW",26,1993,27.5,23,14,9,11,3,12,34,35.3,22,25,1,24,19,42,14,0,"Matches","https://fbref.com/en/comps/9/2020-2021/defense/2020-2021-Premier-League-Stats"
"Edinson Cavani","Manchester Utd",2021,"uy URU","FW",33,1987,15.3,12,8,1,8,3,2,13,15.4,11,2,0,2,6,18,11,0,"Matches","https://fbref.com/en/comps/9/2020-2021/defense/2020-2021-Premier-League-Stats"
"Dani Ceballos","Arsenal",2021,"es ESP","MF",23,1996,17.9,37,22,20,11,6,21,51,41.2,30,23,6,17,35,72,14,1,"Matches","https://fbref.com/en/comps/9/2020-2021/defense/2020-2021-Premier-League-Stats"
"Calum Chambers","Arsenal",2021,"eng ENG","DF",25,1995,8.4,7,3,3,2,2,3,8,37.5,5,6,2,4,10,17,37,0,"Matches","https://fbref.com/en/comps/9/2020-2021/defense/2020-2021-Premier-League-Stats"
"Ben Chilwell","Chelsea",2021,"eng ENG","DF",23,1996,25.4,42,22,16,22,4,15,33,45.5,18,28,3,25,24,66,58,0,"Matches","https://fbref.com/en/comps/9/2020-2021/defense/2020-2021-Premier-League-Stats"
"Hamza Choudhury","Leicester City",2021,"eng ENG","MF",22,1997,3.5,8,7,3,5,0,4,10,40,6,4,1,3,4,12,9,1,"Matches","https://fbref.com/en/comps/9/2020-2021/defense/2020-2021-Premier-League-Stats"
"Andreas Christensen","Chelsea",2021,"dk DEN","DF",24,1996,15.2,11,6,8,3,0,0,8,0,8,19,14,5,20,31,51,1,"Matches","https://fbref.com/en/comps/9/2020-2021/defense/2020-2021-Premier-League-Stats"
"Carney Chukwuemeka","Aston Villa",2021,"eng ENG","MF,FW",16,2003,0.2,2,2,1,0,1,1,3,33.3,2,0,0,0,0,2,0,0,"Matches","https://fbref.com/en/comps/9/2020-2021/defense/2020-2021-Premier-League-Stats"
"Ciaran Clark","Newcastle Utd",2021,"ie IRL","DF",30,1989,21,24,14,15,6,3,6,13,46.2,7,27,20,7,29,53,104,1,"Matches","https://fbref.com/en/comps/9/2020-2021/defense/2020-2021-Premier-League-Stats"
"Nathaniel Clyne","Crystal Palace",2021,"eng ENG","DF",29,1991,12.7,17,10,8,8,1,9,16,56.3,7,7,2,5,18,35,25,1,"Matches","https://fbref.com/en/comps/9/2020-2021/defense/2020-2021-Premier-League-Stats"
"Conor Coady","Wolves",2021,"eng ENG","DF",27,1993,36.7,35,23,25,10,0,19,35,54.3,16,40,32,8,27,62,134,2,"Matches","https://fbref.com/en/comps/9/2020-2021/defense/2020-2021-Premier-League-Stats"
"Séamus Coleman","Everton",2021,"ie IRL","DF,MF",31,1988,17.9,39,26,21,14,4,21,30,70,9,22,6,16,13,52,37,2,"Matches","https://fbref.com/en/comps/9/2020-2021/defense/2020-2021-Premier-League-Stats"
"Aaron Connolly","Brighton",2021,"ie IRL","FW",20,2000,8.8,6,3,1,3,2,0,2,0,2,4,0,4,0,6,2,0,"Matches","https://fbref.com/en/comps/9/2020-2021/defense/2020-2021-Premier-League-Stats"
"Liam Cooper","Leeds United",2021,"sct SCO","DF",28,1991,24.3,68,45,39,27,2,37,59,62.7,22,39,32,7,61,129,70,1,"Matches","https://fbref.com/en/comps/9/2020-2021/defense/2020-2021-Premier-League-Stats"
"Theo Corbeanu","Wolves",2021,"ca CAN","FW",18,2002,0.1,2,1,0,2,0,1,1,100,0,0,0,0,1,3,0,0,"Matches","https://fbref.com/en/comps/9/2020-2021/defense/2020-2021-Premier-League-Stats"
"Jack Cork","Burnley",2021,"eng ENG","MF",31,1989,15,26,10,5,17,4,11,31,35.5,20,15,4,11,16,42,20,0,"Matches","https://fbref.com/en/comps/9/2020-2021/defense/2020-2021-Premier-League-Stats"
"Hélder Costa","Leeds United",2021,"ao ANG","MF,FW",26,1994,12.8,25,11,12,5,8,11,32,34.4,21,11,0,11,3,28,5,1,"Matches","https://fbref.com/en/comps/9/2020-2021/defense/2020-2021-Premier-League-Stats"
"Vladimír Coufal","West Ham",2021,"cz CZE","DF",27,1992,33.9,73,36,50,15,8,52,89,58.4,37,41,7,34,41,114,102,1,"Matches","https://fbref.com/en/comps/9/2020-2021/defense/2020-2021-Premier-League-Stats"
"Aaron Cresswell","West Ham",2021,"eng ENG","DF",30,1989,35.2,32,13,15,15,2,18,32,56.3,14,29,14,15,32,64,79,2,"Matches","https://fbref.com/en/comps/9/2020-2021/defense/2020-2021-Premier-League-Stats"
"Patrick Cutrone","Wolves",2021,"it ITA","FW",22,1998,0.3,0,0,0,0,0,0,0,NA,0,0,0,0,0,0,0,0,"Matches","https://fbref.com/en/comps/9/2020-2021/defense/2020-2021-Premier-League-Stats"
"Stuart Dallas","Leeds United",2021,"nir NIR","MF,DF",29,1991,37.9,74,45,46,22,6,30,88,34.1,58,41,3,38,44,118,52,1,"Matches","https://fbref.com/en/comps/9/2020-2021/defense/2020-2021-Premier-League-Stats"
"Scott Dann","Crystal Palace",2021,"eng ENG","DF",33,1987,15,6,4,5,1,0,4,11,36.4,7,16,14,2,18,24,59,1,"Matches","https://fbref.com/en/comps/9/2020-2021/defense/2020-2021-Premier-League-Stats"
"Karl Darlow","Newcastle Utd",2021,"eng ENG","GK",29,1990,25,0,0,0,0,0,0,0,NA,0,0,0,0,0,0,17,0,"Matches","https://fbref.com/en/comps/9/2020-2021/defense/2020-2021-Premier-League-Stats"
"Ben Davies","Tottenham",2021,"wls WAL","DF",27,1993,15,27,17,10,11,6,13,30,43.3,17,10,5,5,18,45,49,2,"Matches","https://fbref.com/en/comps/9/2020-2021/defense/2020-2021-Premier-League-Stats"
"Tom Davies","Everton",2021,"eng ENG","MF",22,1998,15.8,31,18,17,12,2,16,39,41,23,15,9,6,34,65,21,2,"Matches","https://fbref.com/en/comps/9/2020-2021/defense/2020-2021-Premier-League-Stats"
"Keinan Davis","Aston Villa",2021,"eng ENG","FW,MF",22,1998,3.1,2,1,1,0,1,0,1,0,1,1,0,1,0,2,2,0,"Matches","https://fbref.com/en/comps/9/2020-2021/defense/2020-2021-Premier-League-Stats"
"Leif Davis","Leeds United",2021,"eng ENG","DF",20,2000,0.4,0,0,0,0,0,0,3,0,3,1,0,1,1,1,0,0,"Matches","https://fbref.com/en/comps/9/2020-2021/defense/2020-2021-Premier-League-Stats"
"Craig Dawson","West Ham",2021,"eng ENG","DF",30,1990,21.4,11,8,7,4,0,5,12,41.7,7,26,22,4,32,43,88,3,"Matches","https://fbref.com/en/comps/9/2020-2021/defense/2020-2021-Premier-League-Stats"
"Kevin De Bruyne","Manchester City",2021,"be BEL","MF",29,1991,22.2,34,21,6,18,10,13,48,27.1,35,26,1,25,9,43,10,0,"Matches","https://fbref.com/en/comps/9/2020-2021/defense/2020-2021-Premier-League-Stats"
"Liam Delap","Manchester City",2021,"eng ENG","FW",17,2003,0.4,0,0,0,0,0,0,0,NA,0,0,0,0,0,0,0,0,"Matches","https://fbref.com/en/comps/9/2020-2021/defense/2020-2021-Premier-League-Stats"
"Fabian Delph","Everton",2021,"eng ENG","MF,DF",30,1989,3,5,2,3,2,0,1,3,33.3,2,2,0,2,4,9,8,1,"Matches","https://fbref.com/en/comps/9/2020-2021/defense/2020-2021-Premier-League-Stats"
"Leander Dendoncker","Wolves",2021,"be BEL","MF,DF",25,1995,27.8,54,29,29,22,3,31,60,51.7,29,38,15,23,27,81,52,2,"Matches","https://fbref.com/en/comps/9/2020-2021/defense/2020-2021-Premier-League-Stats"
"Mbaye Diagne","West Brom",2021,"sn SEN","FW",28,1991,13.2,4,3,3,0,1,1,4,25,3,2,1,1,1,5,16,0,"Matches","https://fbref.com/en/comps/9/2020-2021/defense/2020-2021-Premier-League-Stats"
"Amad Diallo","Manchester Utd",2021,"ci CIV","FW",18,2002,1.8,3,3,1,2,0,0,0,NA,0,2,1,1,0,3,1,0,"Matches","https://fbref.com/en/comps/9/2020-2021/defense/2020-2021-Premier-League-Stats"
"Ibrahima Diallo","Southampton",2021,"fr FRA","MF",21,1999,11.3,29,16,11,17,1,9,16,56.3,7,10,1,9,10,39,12,2,"Matches","https://fbref.com/en/comps/9/2020-2021/defense/2020-2021-Premier-League-Stats"
"Grady Diangana","West Brom",2021,"eng ENG","MF,FW",22,1998,13.7,35,19,19,9,7,19,43,44.2,24,16,2,14,16,51,9,0,"Matches","https://fbref.com/en/comps/9/2020-2021/defense/2020-2021-Premier-League-Stats"
"Rúben Dias","Manchester City",2021,"pt POR","DF",23,1997,31.6,24,13,13,8,3,4,16,25,12,31,23,8,35,59,92,0,"Matches","https://fbref.com/en/comps/9/2020-2021/defense/2020-2021-Premier-League-Stats"
"Eric Dier","Tottenham",2021,"eng ENG","DF",26,1994,28,23,14,13,10,0,11,18,61.1,7,37,31,6,23,46,123,3,"Matches","https://fbref.com/en/comps/9/2020-2021/defense/2020-2021-Premier-League-Stats"
"Lucas Digne","Everton",2021,"fr FRA","DF,MF",27,1993,29.8,63,38,40,16,7,29,54,53.7,25,42,4,38,31,94,87,0,"Matches","https://fbref.com/en/comps/9/2020-2021/defense/2020-2021-Premier-League-Stats"
"Issa Diop","West Ham",2021,"fr FRA","DF",23,1997,15.3,20,14,12,8,0,7,18,38.9,11,32,22,10,22,42,59,0,"Matches","https://fbref.com/en/comps/9/2020-2021/defense/2020-2021-Premier-League-Stats"
"Moussa Djenepo","Southampton",2021,"ml MLI","MF",22,1998,13.8,52,27,27,17,8,28,63,44.4,35,24,2,22,10,62,14,0,"Matches","https://fbref.com/en/comps/9/2020-2021/defense/2020-2021-Premier-League-Stats"
"Matt Doherty","Tottenham",2021,"ie IRL","DF",28,1992,13.8,29,15,15,10,4,13,33,39.4,20,20,5,15,23,52,46,0,"Matches","https://fbref.com/en/comps/9/2020-2021/defense/2020-2021-Premier-League-Stats"
"Gabriel Dos Santos","Arsenal",2021,"br BRA","DF",22,1997,22.2,25,15,19,5,1,13,19,68.4,6,27,19,8,26,51,74,2,"Matches","https://fbref.com/en/comps/9/2020-2021/defense/2020-2021-Premier-League-Stats"
"Abdoulaye Doucouré","Everton",2021,"ml MLI","MF",27,1993,27.1,52,32,25,19,8,14,43,32.6,29,24,7,17,39,91,31,1,"Matches","https://fbref.com/en/comps/9/2020-2021/defense/2020-2021-Premier-League-Stats"
"Martin Dúbravka","Newcastle Utd",2021,"sk SVK","GK",31,1989,13,0,0,0,0,0,0,0,NA,0,0,0,0,0,0,3,0,"Matches","https://fbref.com/en/comps/9/2020-2021/defense/2020-2021-Premier-League-Stats"
"Paul Dummett","Newcastle Utd",2021,"wls WAL","DF",28,1991,13.9,16,7,11,5,0,13,21,61.9,8,12,7,5,16,32,74,0,"Matches","https://fbref.com/en/comps/9/2020-2021/defense/2020-2021-Premier-League-Stats"
"Lewis Dunk","Brighton",2021,"eng ENG","DF",28,1991,32.6,30,15,20,8,2,16,23,69.6,7,29,20,9,32,62,106,0,"Matches","https://fbref.com/en/comps/9/2020-2021/defense/2020-2021-Premier-League-Stats"
"Jimmy Dunne","Burnley",2021,"ie IRL","DF",22,1997,3,3,3,2,1,0,1,2,50,1,3,2,1,6,9,16,1,"Matches","https://fbref.com/en/comps/9/2020-2021/defense/2020-2021-Premier-League-Stats"
"Ederson","Manchester City",2021,"br BRA","GK",26,1993,36,3,1,3,0,0,3,4,75,1,0,0,0,0,3,11,4,"Matches","https://fbref.com/en/comps/9/2020-2021/defense/2020-2021-Premier-League-Stats"
"Kyle Edwards","West Brom",2021,"eng ENG","MF,FW",22,1998,1.3,3,2,1,1,1,0,0,NA,0,2,0,2,1,4,0,0,"Matches","https://fbref.com/en/comps/9/2020-2021/defense/2020-2021-Premier-League-Stats"
"John Egan","Sheffield Utd",2021,"ie IRL","DF",27,1992,29.2,41,21,29,12,0,22,39,56.4,17,43,31,12,41,82,131,0,"Matches","https://fbref.com/en/comps/9/2020-2021/defense/2020-2021-Premier-League-Stats"
"Anthony Elanga","Manchester Utd",2021,"se SWE","FW",18,2002,1.7,4,2,3,1,0,4,5,80,1,1,1,0,1,5,1,0,"Matches","https://fbref.com/en/comps/9/2020-2021/defense/2020-2021-Premier-League-Stats"
"Ahmed Elmohamady","Aston Villa",2021,"eg EGY","DF",32,1987,9.3,17,13,12,4,1,9,14,64.3,5,6,3,3,17,34,26,0,"Matches","https://fbref.com/en/comps/9/2020-2021/defense/2020-2021-Premier-League-Stats"
"Mohamed Elneny","Arsenal",2021,"eg EGY","MF",28,1992,17.2,14,6,7,7,0,7,28,25,21,11,4,7,24,38,20,2,"Matches","https://fbref.com/en/comps/9/2020-2021/defense/2020-2021-Premier-League-Stats"
"Jonny Evans","Leicester City",2021,"nir NIR","DF",32,1988,27.5,25,12,22,2,1,14,20,70,6,8,3,5,46,71,98,1,"Matches","https://fbref.com/en/comps/9/2020-2021/defense/2020-2021-Premier-League-Stats"
"Eberechi Eze","Crystal Palace",2021,"eng ENG","MF",22,1998,28.4,27,14,11,13,3,16,35,45.7,19,19,3,16,24,51,9,1,"Matches","https://fbref.com/en/comps/9/2020-2021/defense/2020-2021-Premier-League-Stats"
"Lukasz Fabianski","West Ham",2021,"pl POL","GK",35,1985,35,1,0,1,0,0,1,1,100,0,1,0,1,1,2,12,3,"Matches","https://fbref.com/en/comps/9/2020-2021/defense/2020-2021-Premier-League-Stats"
"Fabinho","Liverpool",2021,"br BRA","DF,MF",26,1993,28.5,58,31,21,29,8,27,54,50,27,28,10,18,44,102,66,1,"Matches","https://fbref.com/en/comps/9/2020-2021/defense/2020-2021-Premier-League-Stats"
"Bruno Fernandes","Manchester Utd",2021,"pt POR","MF",25,1994,34.4,57,30,16,29,12,26,100,26,74,38,0,38,26,83,29,0,"Matches","https://fbref.com/en/comps/9/2020-2021/defense/2020-2021-Premier-League-Stats"
"Federico Fernández","Newcastle Utd",2021,"ar ARG","DF",31,1989,23.1,29,22,23,5,1,17,21,81,4,41,31,10,17,46,147,0,"Matches","https://fbref.com/en/comps/9/2020-2021/defense/2020-2021-Premier-League-Stats"
"Fernandinho","Manchester City",2021,"br BRA","MF",35,1985,13.2,31,17,8,14,9,20,43,46.5,23,11,2,9,23,54,17,0,"Matches","https://fbref.com/en/comps/9/2020-2021/defense/2020-2021-Premier-League-Stats"
"Sam Field","West Brom",2021,"eng ENG","MF",22,1998,0.7,5,5,3,2,0,0,0,NA,0,4,1,3,2,7,4,0,"Matches","https://fbref.com/en/comps/9/2020-2021/defense/2020-2021-Premier-League-Stats"
"Roberto Firmino","Liverpool",2021,"br BRA","FW",28,1991,31.5,33,15,3,17,13,6,32,18.8,26,42,5,37,11,44,12,0,"Matches","https://fbref.com/en/comps/9/2020-2021/defense/2020-2021-Premier-League-Stats"
"John Fleck","Sheffield Utd",2021,"sct SCO","MF",28,1991,28.6,51,33,28,18,5,26,83,31.3,57,26,4,22,28,79,12,1,"Matches","https://fbref.com/en/comps/9/2020-2021/defense/2020-2021-Premier-League-Stats"
"Phil Foden","Manchester City",2021,"eng ENG","FW,MF",20,2000,18,22,11,12,8,2,9,23,39.1,14,9,0,9,11,33,11,0,"Matches","https://fbref.com/en/comps/9/2020-2021/defense/2020-2021-Premier-League-Stats"
"Wesley Fofana","Leicester City",2021,"fr FRA","DF",19,2000,25.1,51,37,27,22,2,31,46,67.4,15,28,16,12,61,112,94,0,"Matches","https://fbref.com/en/comps/9/2020-2021/defense/2020-2021-Premier-League-Stats"
"Pablo Fornals","West Ham",2021,"es ESP","FW,MF",24,1996,28.6,44,26,14,24,6,11,73,15.1,62,43,1,42,36,80,9,0,"Matches","https://fbref.com/en/comps/9/2020-2021/defense/2020-2021-Premier-League-Stats"
"Fraser Forster","Southampton",2021,"eng ENG","GK",32,1988,8,1,0,1,0,0,1,2,50,1,0,0,0,0,1,9,0,"Matches","https://fbref.com/en/comps/9/2020-2021/defense/2020-2021-Premier-League-Stats"
"Timothy Fosu-Mensah","Manchester Utd",2021,"nl NED","DF",22,1998,0.9,2,0,1,1,0,1,1,100,0,0,0,0,3,5,1,0,"Matches","https://fbref.com/en/comps/9/2020-2021/defense/2020-2021-Premier-League-Stats"
"Tyrese Francois","Fulham",2021,"au AUS","DF",20,2000,0.2,0,0,0,0,0,0,0,NA,0,0,0,0,0,0,0,0,"Matches","https://fbref.com/en/comps/9/2020-2021/defense/2020-2021-Premier-League-Stats"
"Ryan Fraser","Newcastle Utd",2021,"sct SCO","FW,MF",26,1994,10.3,4,1,3,1,0,2,5,40,3,1,0,1,6,10,7,0,"Matches","https://fbref.com/en/comps/9/2020-2021/defense/2020-2021-Premier-League-Stats"
"Fred","Manchester Utd",2021,"br BRA","MF",27,1993,26.6,81,39,39,38,4,29,89,32.6,60,49,9,40,45,126,26,1,"Matches","https://fbref.com/en/comps/9/2020-2021/defense/2020-2021-Premier-League-Stats"
"Ryan Fredericks","West Ham",2021,"eng ENG","DF,FW",27,1992,6.3,9,5,5,4,0,3,7,42.9,4,6,2,4,11,20,20,0,"Matches","https://fbref.com/en/comps/9/2020-2021/defense/2020-2021-Premier-League-Stats"
"Christian Fuchs","Leicester City",2021,"at AUT","DF",34,1986,7.8,18,7,15,2,1,8,15,53.3,7,6,4,2,16,34,34,1,"Matches","https://fbref.com/en/comps/9/2020-2021/defense/2020-2021-Premier-League-Stats"
"Darnell Furlong","West Brom",2021,"eng ENG","DF",24,1995,32.6,45,27,27,12,6,21,44,47.7,23,39,16,23,49,94,90,0,"Matches","https://fbref.com/en/comps/9/2020-2021/defense/2020-2021-Premier-League-Stats"
"Conor Gallagher","West Brom",2021,"eng ENG","MF",20,2000,28.1,81,41,30,39,12,29,97,29.9,68,47,8,39,27,108,31,0,"Matches","https://fbref.com/en/comps/9/2020-2021/defense/2020-2021-Premier-League-Stats"
"Eric García","Manchester City",2021,"es ESP","DF",19,2001,4.3,8,7,5,3,0,5,7,71.4,2,4,1,3,4,12,10,0,"Matches","https://fbref.com/en/comps/9/2020-2021/defense/2020-2021-Premier-League-Stats"
"Dwight Gayle","Newcastle Utd",2021,"eng ENG","FW,MF",29,1990,5.7,2,0,1,1,0,0,7,0,7,3,1,2,1,3,2,0,"Matches","https://fbref.com/en/comps/9/2020-2021/defense/2020-2021-Premier-League-Stats"
"Jean-Philippe Gbamin","Everton",2021,"ci CIV","MF",24,1995,0.1,1,0,0,1,0,0,0,NA,0,1,0,1,0,1,1,0,"Matches","https://fbref.com/en/comps/9/2020-2021/defense/2020-2021-Premier-League-Stats"
"David de Gea","Manchester Utd",2021,"es ESP","GK",29,1990,25.5,0,0,0,0,0,0,0,NA,0,0,0,0,0,0,8,3,"Matches","https://fbref.com/en/comps/9/2020-2021/defense/2020-2021-Premier-League-Stats"
"Anwar El Ghazi","Aston Villa",2021,"nl NED","FW",25,1995,17.9,16,13,6,7,3,7,23,30.4,16,11,0,11,6,22,11,0,"Matches","https://fbref.com/en/comps/9/2020-2021/defense/2020-2021-Premier-League-Stats"
"Kieran Gibbs","West Brom",2021,"eng ENG","DF",30,1989,9,15,11,11,3,1,8,10,80,2,8,6,2,16,31,30,1,"Matches","https://fbref.com/en/comps/9/2020-2021/defense/2020-2021-Premier-League-Stats"
"Morgan Gibbs-White","Wolves",2021,"eng ENG","MF,FW",20,2000,4.6,9,7,3,4,2,5,12,41.7,7,6,0,6,3,12,1,0,"Matches","https://fbref.com/en/comps/9/2020-2021/defense/2020-2021-Premier-League-Stats"
"Billy Gilmour","Chelsea",2021,"sct SCO","MF",19,2001,2.9,4,2,1,2,1,2,7,28.6,5,3,2,1,3,7,1,0,"Matches","https://fbref.com/en/comps/9/2020-2021/defense/2020-2021-Premier-League-Stats"
"Olivier Giroud","Chelsea",2021,"fr FRA","FW",33,1986,8.3,4,2,0,1,3,1,7,14.3,6,4,1,3,5,9,10,0,"Matches","https://fbref.com/en/comps/9/2020-2021/defense/2020-2021-Premier-League-Stats"
"Ben Godfrey","Everton",2021,"eng ENG","DF",22,1998,29.8,55,33,37,15,3,27,41,65.9,14,56,37,19,33,88,120,0,"Matches","https://fbref.com/en/comps/9/2020-2021/defense/2020-2021-Premier-League-Stats"
"André Gomes","Everton",2021,"pt POR","MF",27,1993,17.4,35,23,16,16,3,17,58,29.3,41,19,1,18,10,45,12,1,"Matches","https://fbref.com/en/comps/9/2020-2021/defense/2020-2021-Premier-League-Stats"
"Joe Gomez","Liverpool",2021,"eng ENG","DF",23,1997,6.6,3,2,1,1,1,0,4,0,4,3,2,1,4,7,29,0,"Matches","https://fbref.com/en/comps/9/2020-2021/defense/2020-2021-Premier-League-Stats"
"Anthony Gordon","Everton",2021,"eng ENG","FW,MF",19,2001,1,3,3,3,0,0,0,2,0,2,1,0,1,1,4,3,0,"Matches","https://fbref.com/en/comps/9/2020-2021/defense/2020-2021-Premier-League-Stats"
"Karlan Grant","West Brom",2021,"eng ENG","FW,MF",22,1997,12.5,5,3,3,2,0,2,4,50,2,7,0,7,5,10,17,0,"Matches","https://fbref.com/en/comps/9/2020-2021/defense/2020-2021-Premier-League-Stats"
"Demarai Gray","Leicester City",2021,"eng ENG","FW",24,1996,0.2,1,1,1,0,0,0,0,NA,0,0,0,0,0,1,0,0,"Matches","https://fbref.com/en/comps/9/2020-2021/defense/2020-2021-Premier-League-Stats"
"Jack Grealish","Aston Villa",2021,"eng ENG","FW,MF",24,1995,24.3,31,14,8,16,7,15,24,62.5,9,20,3,17,12,43,5,3,"Matches","https://fbref.com/en/comps/9/2020-2021/defense/2020-2021-Premier-League-Stats"
"Mason Greenwood","Manchester Utd",2021,"eng ENG","FW",18,2001,20.2,13,10,6,4,3,5,22,22.7,17,9,0,9,5,18,1,0,"Matches","https://fbref.com/en/comps/9/2020-2021/defense/2020-2021-Premier-League-Stats"
"Pascal Groß","Brighton",2021,"de GER","MF,DF",29,1991,27.6,45,24,24,15,6,24,53,45.3,29,25,4,21,23,68,18,1,"Matches","https://fbref.com/en/comps/9/2020-2021/defense/2020-2021-Premier-League-Stats"
"Kamil Grosicki","West Brom",2021,"pl POL","MF,FW",32,1988,1.6,2,1,2,0,0,2,8,25,6,1,0,1,2,4,1,0,"Matches","https://fbref.com/en/comps/9/2020-2021/defense/2020-2021-Premier-League-Stats"
"Vicente Guaita","Crystal Palace",2021,"es ESP","GK",33,1987,37,1,1,1,0,0,1,1,100,0,0,0,0,1,2,11,1,"Matches","https://fbref.com/en/comps/9/2020-2021/defense/2020-2021-Premier-League-Stats"
"Ilkay Gündogan","Manchester City",2021,"de GER","MF",29,1990,22.5,25,15,8,12,5,10,39,25.6,29,13,4,9,20,45,9,0,"Matches","https://fbref.com/en/comps/9/2020-2021/defense/2020-2021-Premier-League-Stats"
"Antwoine Hackford","Sheffield Utd",2021,"eng ENG","DF",16,2004,0.1,0,0,0,0,0,0,0,NA,0,0,0,0,0,0,0,0,"Matches","https://fbref.com/en/comps/9/2020-2021/defense/2020-2021-Premier-League-Stats"
"Sébastien Haller","West Ham",2021,"ci CIV","FW",26,1994,10.4,14,9,1,6,7,4,20,20,16,7,1,6,5,19,7,0,"Matches","https://fbref.com/en/comps/9/2020-2021/defense/2020-2021-Premier-League-Stats"
"Rekeem Harper","West Brom",2021,"eng ENG","MF",20,2000,0.4,0,0,0,0,0,0,0,NA,0,2,0,2,1,1,0,0,"Matches","https://fbref.com/en/comps/9/2020-2021/defense/2020-2021-Premier-League-Stats"
"Jack Harrison","Leeds United",2021,"eng ENG","MF,FW",23,1996,31.6,63,38,20,30,13,26,59,44.1,33,30,2,28,15,78,21,0,"Matches","https://fbref.com/en/comps/9/2020-2021/defense/2020-2021-Premier-League-Stats"
"Kortney Hause","Aston Villa",2021,"eng ENG","DF",25,1995,7,4,2,3,1,0,0,3,0,3,4,2,2,8,12,53,0,"Matches","https://fbref.com/en/comps/9/2020-2021/defense/2020-2021-Premier-League-Stats"
"Kai Havertz","Chelsea",2021,"de GER","MF,FW",21,1999,16.9,18,9,6,10,2,6,27,22.2,21,25,0,25,4,22,22,1,"Matches","https://fbref.com/en/comps/9/2020-2021/defense/2020-2021-Premier-League-Stats"
"Isaac Hayden","Newcastle Utd",2021,"eng ENG","MF,DF",25,1995,21.6,52,29,23,22,7,14,35,40,21,32,9,23,43,95,47,0,"Matches","https://fbref.com/en/comps/9/2020-2021/defense/2020-2021-Premier-League-Stats"
"Michael Hector","Fulham",2021,"jm JAM","DF",28,1992,2.9,3,2,1,2,0,1,6,16.7,5,4,2,2,0,3,6,0,"Matches","https://fbref.com/en/comps/9/2020-2021/defense/2020-2021-Premier-League-Stats"
"Ahmed Hegazi","West Brom",2021,"eg EGY","DF",29,1991,1,0,0,0,0,0,0,0,NA,0,2,0,2,1,1,7,0,"Matches","https://fbref.com/en/comps/9/2020-2021/defense/2020-2021-Premier-League-Stats"
"Dean Henderson","Manchester Utd",2021,"eng ENG","GK",23,1997,12.5,1,1,1,0,0,1,2,50,1,0,0,0,0,1,3,2,"Matches","https://fbref.com/en/comps/9/2020-2021/defense/2020-2021-Premier-League-Stats"
"Jordan Henderson","Liverpool",2021,"eng ENG","MF,DF",30,1990,18.9,24,15,12,9,3,10,26,38.5,16,12,1,11,34,58,30,0,"Matches","https://fbref.com/en/comps/9/2020-2021/defense/2020-2021-Premier-League-Stats"
"Jeff Hendrick","Newcastle Utd",2021,"ie IRL","MF",28,1992,15.8,8,3,5,3,0,1,13,7.7,12,14,9,5,19,27,18,0,"Matches","https://fbref.com/en/comps/9/2020-2021/defense/2020-2021-Premier-League-Stats"
"Pablo Hernández","Leeds United",2021,"es ESP","MF",35,1985,4.7,5,3,2,1,2,5,16,31.3,11,2,0,2,0,5,0,1,"Matches","https://fbref.com/en/comps/9/2020-2021/defense/2020-2021-Premier-League-Stats"
"Son Heung-min","Tottenham",2021,"kr KOR","FW",28,1992,34.6,32,18,11,14,7,18,72,25,54,28,3,25,14,46,8,0,"Matches","https://fbref.com/en/comps/9/2020-2021/defense/2020-2021-Premier-League-Stats"
"Ki-Jana Hoever","Wolves",2021,"nl NED","DF,MF",18,2002,6.4,14,6,11,2,1,10,22,45.5,12,2,0,2,9,23,23,0,"Matches","https://fbref.com/en/comps/9/2020-2021/defense/2020-2021-Premier-League-Stats"
"Rob Holding","Arsenal",2021,"eng ENG","DF",24,1995,28.4,43,20,28,13,2,17,35,48.6,18,37,27,10,24,67,120,0,"Matches","https://fbref.com/en/comps/9/2020-2021/defense/2020-2021-Premier-League-Stats"
"Mason Holgate","Everton",2021,"eng ENG","DF",23,1996,25.4,56,36,31,18,7,20,50,40,30,37,13,24,35,91,90,3,"Matches","https://fbref.com/en/comps/9/2020-2021/defense/2020-2021-Premier-League-Stats"
"Conor Hourihane","Aston Villa",2021,"ie IRL","MF",29,1991,2.5,0,0,0,0,0,0,2,0,2,3,0,3,0,0,2,0,"Matches","https://fbref.com/en/comps/9/2020-2021/defense/2020-2021-Premier-League-Stats"
"Callum Hudson-Odoi","Chelsea",2021,"eng ENG","FW,DF",19,2000,11.8,23,15,11,7,5,8,21,38.1,13,15,1,14,6,29,6,0,"Matches","https://fbref.com/en/comps/9/2020-2021/defense/2020-2021-Premier-League-Stats"
"Niall Huggins","Leeds United",2021,"wls WAL","DF",19,2000,0.4,0,0,0,0,0,0,1,0,1,0,0,0,0,0,1,0,"Matches","https://fbref.com/en/comps/9/2020-2021/defense/2020-2021-Premier-League-Stats"
"Pierre Højbjerg","Tottenham",2021,"dk DEN","MF",24,1995,38,98,51,45,42,11,54,129,41.9,75,51,9,42,48,146,66,0,"Matches","https://fbref.com/en/comps/9/2020-2021/defense/2020-2021-Premier-League-Stats"
"Odion Ighalo","Manchester Utd",2021,"ng NGA","FW",31,1989,0.1,0,0,0,0,0,0,1,0,1,0,0,0,0,0,0,0,"Matches","https://fbref.com/en/comps/9/2020-2021/defense/2020-2021-Premier-League-Stats"
"Kelechi Iheanacho","Leicester City",2021,"ng NGA","FW",23,1996,16.2,12,5,2,4,6,4,17,23.5,13,14,0,14,2,14,1,1,"Matches","https://fbref.com/en/comps/9/2020-2021/defense/2020-2021-Premier-League-Stats"
"Danny Ings","Southampton",2021,"eng ENG","FW",28,1992,24.1,22,13,3,16,3,12,28,42.9,16,39,2,37,3,25,27,1,"Matches","https://fbref.com/en/comps/9/2020-2021/defense/2020-2021-Premier-League-Stats"
"Branislav Ivanovic","West Brom",2021,"rs SRB","DF",36,1984,8.5,14,5,11,3,0,7,13,53.8,6,11,5,6,8,22,25,0,"Matches","https://fbref.com/en/comps/9/2020-2021/defense/2020-2021-Premier-League-Stats"
"Alex Iwobi","Everton",2021,"ng NGA","FW,MF",24,1996,17.1,27,10,10,14,3,13,25,52,12,20,1,19,16,43,14,0,"Matches","https://fbref.com/en/comps/9/2020-2021/defense/2020-2021-Premier-League-Stats"
"José Izquierdo","Brighton",2021,"co COL","DF",28,1992,0.1,0,0,0,0,0,0,0,NA,0,0,0,0,0,0,0,0,"Matches","https://fbref.com/en/comps/9/2020-2021/defense/2020-2021-Premier-League-Stats"
"Phil Jagielka","Sheffield Utd",2021,"eng ENG","DF",37,1982,5.8,5,4,4,0,1,2,7,28.6,5,11,5,6,10,15,26,2,"Matches","https://fbref.com/en/comps/9/2020-2021/defense/2020-2021-Premier-League-Stats"
"Alireza Jahanbakhsh","Brighton",2021,"ir IRN","FW,MF",26,1993,5.9,9,7,3,5,1,2,12,16.7,10,8,0,8,8,17,1,0,"Matches","https://fbref.com/en/comps/9/2020-2021/defense/2020-2021-Premier-League-Stats"
"Daniel James","Manchester Utd",2021,"wls WAL","FW",22,1997,10.1,15,9,4,7,4,3,18,16.7,15,10,1,9,0,15,6,0,"Matches","https://fbref.com/en/comps/9/2020-2021/defense/2020-2021-Premier-League-Stats"
"Reece James","Chelsea",2021,"eng ENG","DF",20,1999,26.4,55,35,24,22,9,21,44,47.7,23,36,7,29,17,72,52,0,"Matches","https://fbref.com/en/comps/9/2020-2021/defense/2020-2021-Premier-League-Stats"
"Alexandre Jankewitz","Southampton",2021,"ch SUI","MF",18,2001,0,2,1,2,0,0,1,1,100,0,0,0,0,0,2,0,0,"Matches","https://fbref.com/en/comps/9/2020-2021/defense/2020-2021-Premier-League-Stats"
"Daniel Jebbison","Sheffield Utd",2021,"eng ENG","FW",16,2003,3.2,6,2,1,3,2,3,7,42.9,4,6,1,5,1,7,0,0,"Matches","https://fbref.com/en/comps/9/2020-2021/defense/2020-2021-Premier-League-Stats"
"Gabriel Jesus","Manchester City",2021,"br BRA","FW",23,1997,22.9,17,6,5,5,7,11,28,39.3,17,16,0,16,15,32,5,0,"Matches","https://fbref.com/en/comps/9/2020-2021/defense/2020-2021-Premier-League-Stats"
"Raúl Jiménez","Wolves",2021,"mx MEX","FW",29,1991,9.1,3,2,1,2,0,0,7,0,7,2,0,2,8,11,12,0,"Matches","https://fbref.com/en/comps/9/2020-2021/defense/2020-2021-Premier-League-Stats"
"Joelinton","Newcastle Utd",2021,"br BRA","FW,MF",23,1996,22,33,21,7,21,5,14,37,37.8,23,30,2,28,9,42,24,0,"Matches","https://fbref.com/en/comps/9/2020-2021/defense/2020-2021-Premier-League-Stats"
"Ben Johnson","West Ham",2021,"eng ENG","DF,FW",20,2000,5.8,11,5,5,3,3,7,9,77.8,2,5,1,4,11,22,9,0,"Matches","https://fbref.com/en/comps/9/2020-2021/defense/2020-2021-Premier-League-Stats"
"Sam Johnstone","West Brom",2021,"eng ENG","GK",27,1993,37,0,0,0,0,0,0,0,NA,0,0,0,0,2,2,15,2,"Matches","https://fbref.com/en/comps/9/2020-2021/defense/2020-2021-Premier-League-Stats"
"Curtis Jones","Liverpool",2021,"eng ENG","MF",19,2001,13.1,16,6,6,7,3,12,25,48,13,13,0,13,19,35,11,1,"Matches","https://fbref.com/en/comps/9/2020-2021/defense/2020-2021-Premier-League-Stats"
"Jorginho","Chelsea",2021,"it ITA","MF",28,1991,22.3,57,30,22,31,4,31,76,40.8,45,33,5,28,40,97,21,3,"Matches","https://fbref.com/en/comps/9/2020-2021/defense/2020-2021-Premier-League-Stats"
"Willian José","Wolves",2021,"br BRA","FW",28,1991,12.3,2,1,1,1,0,1,4,25,3,6,1,5,1,3,12,0,"Matches","https://fbref.com/en/comps/9/2020-2021/defense/2020-2021-Premier-League-Stats"
"Diogo Jota","Liverpool",2021,"pt POR","FW",23,1996,12.4,12,6,4,7,1,2,29,6.9,27,9,0,9,5,17,3,0,"Matches","https://fbref.com/en/comps/9/2020-2021/defense/2020-2021-Premier-League-Stats"
"James Justin","Leicester City",2021,"eng ENG","DF",22,1998,23,61,37,38,18,5,20,41,48.8,21,36,10,26,30,91,58,1,"Matches","https://fbref.com/en/comps/9/2020-2021/defense/2020-2021-Premier-League-Stats"
"Ozan Kabak","Liverpool",2021,"tr TUR","DF",20,2000,8.9,19,10,11,4,4,6,9,66.7,3,2,2,0,12,31,28,1,"Matches","https://fbref.com/en/comps/9/2020-2021/defense/2020-2021-Premier-League-Stats"
"Aboubakar Kamara","Fulham",2021,"mr MTN","FW,MF",25,1995,3.5,2,2,1,1,0,0,5,0,5,6,0,6,1,3,0,0,"Matches","https://fbref.com/en/comps/9/2020-2021/defense/2020-2021-Premier-League-Stats"
"Harry Kane","Tottenham",2021,"eng ENG","FW",27,1993,34.2,22,12,1,17,4,8,26,30.8,18,28,11,17,11,33,40,0,"Matches","https://fbref.com/en/comps/9/2020-2021/defense/2020-2021-Premier-League-Stats"
"N'Golo Kanté","Chelsea",2021,"fr FRA","MF",29,1991,23.8,79,42,39,35,5,27,56,48.2,29,42,4,38,59,138,34,0,"Matches","https://fbref.com/en/comps/9/2020-2021/defense/2020-2021-Premier-League-Stats"
"Moise Kean","Everton",2021,"it ITA","FW,MF",20,2000,0.2,0,0,0,0,0,0,0,NA,0,0,0,0,0,0,0,0,"Matches","https://fbref.com/en/comps/9/2020-2021/defense/2020-2021-Premier-League-Stats"
"Michael Keane","Everton",2021,"eng ENG","DF",27,1993,33.2,28,15,20,8,0,14,31,45.2,17,46,33,13,51,79,161,0,"Matches","https://fbref.com/en/comps/9/2020-2021/defense/2020-2021-Premier-League-Stats"
"Neeskens Kebano","Fulham",2021,"cd COD","FW,MF",28,1992,1.3,0,0,0,0,0,0,1,0,1,3,0,3,0,0,0,0,"Matches","https://fbref.com/en/comps/9/2020-2021/defense/2020-2021-Premier-League-Stats"
"Naby Keïta","Liverpool",2021,"gn GUI","MF",25,1995,5.8,11,5,1,8,2,7,17,41.2,10,10,0,10,9,20,6,0,"Matches","https://fbref.com/en/comps/9/2020-2021/defense/2020-2021-Premier-League-Stats"
"Caoimhín Kelleher","Liverpool",2021,"ie IRL","GK",21,1998,2,0,0,0,0,0,0,0,NA,0,0,0,0,0,0,2,0,"Matches","https://fbref.com/en/comps/9/2020-2021/defense/2020-2021-Premier-League-Stats"
"Martin Kelly","Crystal Palace",2021,"eng ENG","DF",30,1990,0,1,0,1,0,0,1,1,100,0,0,0,0,0,1,0,0,"Matches","https://fbref.com/en/comps/9/2020-2021/defense/2020-2021-Premier-League-Stats"
"Jonjoe Kenny","Everton",2021,"eng ENG","DF",23,1997,0.9,2,1,1,0,1,2,2,100,0,0,0,0,1,3,3,0,"Matches","https://fbref.com/en/comps/9/2020-2021/defense/2020-2021-Premier-League-Stats"
"Reda Khadra","Brighton",2021,"de GER","MF",19,2001,0.1,0,0,0,0,0,0,0,NA,0,0,0,0,0,0,0,0,"Matches","https://fbref.com/en/comps/9/2020-2021/defense/2020-2021-Premier-League-Stats"
"Max Kilman","Wolves",2021,"eng ENG","DF",23,1997,14.6,21,14,13,4,4,8,14,57.1,6,17,8,9,19,40,46,0,"Matches","https://fbref.com/en/comps/9/2020-2021/defense/2020-2021-Premier-League-Stats"
"Joshua King","Everton",2021,"no NOR","MF,FW",28,1992,1.6,4,1,2,1,1,0,0,NA,0,3,0,3,1,5,1,0,"Matches","https://fbref.com/en/comps/9/2020-2021/defense/2020-2021-Premier-League-Stats"
"Mateusz Klich","Leeds United",2021,"pl POL","MF",30,1990,26.6,38,20,14,20,4,14,61,23,47,13,4,9,11,49,16,0,"Matches","https://fbref.com/en/comps/9/2020-2021/defense/2020-2021-Premier-League-Stats"
"Robin Koch","Leeds United",2021,"de GER","DF,MF",24,1996,12.6,27,16,17,10,0,10,19,52.6,9,18,12,6,27,54,34,2,"Matches","https://fbref.com/en/comps/9/2020-2021/defense/2020-2021-Premier-League-Stats"
"Sead Kolainac","Arsenal",2021,"ba BIH","DF",27,1993,1,0,0,0,0,0,0,0,NA,0,0,0,0,1,1,0,0,"Matches","https://fbref.com/en/comps/9/2020-2021/defense/2020-2021-Premier-League-Stats"
"Terence Kongolo","Fulham",2021,"nl NED","DF",26,1994,1,3,2,1,2,0,1,1,100,0,0,0,0,2,5,3,0,"Matches","https://fbref.com/en/comps/9/2020-2021/defense/2020-2021-Premier-League-Stats"
"Ezri Konsa","Aston Villa",2021,"eng ENG","DF",22,1997,35.5,25,13,18,6,1,9,13,69.2,4,53,47,6,29,54,162,1,"Matches","https://fbref.com/en/comps/9/2020-2021/defense/2020-2021-Premier-League-Stats"
"Cheikhou Kouyaté","Crystal Palace",2021,"sn SEN","DF",30,1989,34.7,58,37,44,12,2,25,43,58.1,18,42,26,16,32,90,125,2,"Matches","https://fbref.com/en/comps/9/2020-2021/defense/2020-2021-Premier-League-Stats"
"Mateo Kovacic","Chelsea",2021,"hr CRO","MF",26,1994,20.2,46,28,19,24,3,17,32,53.1,15,18,1,17,15,61,11,2,"Matches","https://fbref.com/en/comps/9/2020-2021/defense/2020-2021-Premier-League-Stats"
"Emil Krafth","Newcastle Utd",2021,"se SWE","DF",25,1994,14.3,19,8,9,9,1,12,25,48,13,15,9,6,15,34,52,2,"Matches","https://fbref.com/en/comps/9/2020-2021/defense/2020-2021-Premier-League-Stats"
"Filip Krovinovic","West Brom",2021,"hr CRO","MF",24,1995,6.1,13,10,6,5,2,6,18,33.3,12,2,0,2,4,17,2,0,"Matches","https://fbref.com/en/comps/9/2020-2021/defense/2020-2021-Premier-League-Stats"
"Alexandre Lacazette","Arsenal",2021,"fr FRA","FW",29,1991,21.4,18,10,4,11,3,4,22,18.2,18,20,1,19,12,30,13,0,"Matches","https://fbref.com/en/comps/9/2020-2021/defense/2020-2021-Premier-League-Stats"
"Adam Lallana","Brighton",2021,"eng ENG","MF,FW",32,1988,17.7,28,13,11,13,4,8,39,20.5,31,18,3,15,15,43,13,0,"Matches","https://fbref.com/en/comps/9/2020-2021/defense/2020-2021-Premier-League-Stats"
"Érik Lamela","Tottenham",2021,"ar ARG","FW,MF",28,1992,8,17,9,1,11,5,8,21,38.1,13,11,1,10,6,23,2,0,"Matches","https://fbref.com/en/comps/9/2020-2021/defense/2020-2021-Premier-League-Stats"
"Tariq Lamptey","Brighton",2021,"gh GHA","DF,MF",19,2000,9.8,17,9,7,6,4,6,13,46.2,7,8,1,7,19,36,12,1,"Matches","https://fbref.com/en/comps/9/2020-2021/defense/2020-2021-Premier-League-Stats"
"Manuel Lanzini","West Ham",2021,"ar ARG","MF,FW",27,1993,6.3,9,2,3,4,2,3,10,30,7,9,0,9,7,16,5,0,"Matches","https://fbref.com/en/comps/9/2020-2021/defense/2020-2021-Premier-League-Stats"
"Aymeric Laporte","Manchester City",2021,"es ESP","DF",26,1994,14.9,13,6,10,3,0,7,11,63.6,4,12,7,5,11,24,28,0,"Matches","https://fbref.com/en/comps/9/2020-2021/defense/2020-2021-Premier-League-Stats"
"Jamaal Lascelles","Newcastle Utd",2021,"eng ENG","DF",26,1993,18.1,14,7,5,9,0,3,6,50,3,27,17,10,12,26,86,0,"Matches","https://fbref.com/en/comps/9/2020-2021/defense/2020-2021-Premier-League-Stats"
"Maxime Le Marchand","Fulham",2021,"fr FRA","DF",30,1989,1.4,2,2,2,0,0,2,2,100,0,0,0,0,0,2,3,0,"Matches","https://fbref.com/en/comps/9/2020-2021/defense/2020-2021-Premier-League-Stats"
"Mario Lemina","Fulham",2021,"ga GAB","MF",26,1993,18.9,62,35,25,30,7,23,44,52.3,21,26,5,21,30,92,21,0,"Matches","https://fbref.com/en/comps/9/2020-2021/defense/2020-2021-Premier-League-Stats"
"Bernd Leno","Arsenal",2021,"de GER","GK",28,1992,34.8,1,0,1,0,0,1,1,100,0,1,0,1,0,1,11,2,"Matches","https://fbref.com/en/comps/9/2020-2021/defense/2020-2021-Premier-League-Stats"
"Khanya Leshabela","Leicester City",2021,"za RSA","MF",20,1999,0.1,0,0,0,0,0,0,0,NA,0,0,0,0,0,0,0,0,"Matches","https://fbref.com/en/comps/9/2020-2021/defense/2020-2021-Premier-League-Stats"
"Jamal Lewis","Newcastle Utd",2021,"nir NIR","DF",22,1998,20.4,37,20,23,13,1,16,38,42.1,22,21,7,14,11,48,44,1,"Matches","https://fbref.com/en/comps/9/2020-2021/defense/2020-2021-Premier-League-Stats"
"Victor Lindelöf","Manchester Utd",2021,"se SWE","DF",26,1994,28.7,22,10,12,10,0,12,24,50,12,22,14,8,30,52,95,1,"Matches","https://fbref.com/en/comps/9/2020-2021/defense/2020-2021-Premier-League-Stats"
"Jesse Lingard","West Ham",2021,"eng ENG","MF,FW",27,1992,15.8,12,6,4,8,0,5,14,35.7,9,7,1,6,4,16,0,0,"Matches","https://fbref.com/en/comps/9/2020-2021/defense/2020-2021-Premier-League-Stats"
"Jake Livermore","West Brom",2021,"eng ENG","MF",30,1989,13.8,33,18,14,16,3,14,31,45.2,17,21,6,15,16,49,26,0,"Matches","https://fbref.com/en/comps/9/2020-2021/defense/2020-2021-Premier-League-Stats"
"Diego Llorente","Leeds United",2021,"es ESP","DF",26,1993,13.4,34,21,21,13,0,19,32,59.4,13,18,13,5,20,54,40,2,"Matches","https://fbref.com/en/comps/9/2020-2021/defense/2020-2021-Premier-League-Stats"
"Hugo Lloris","Tottenham",2021,"fr FRA","GK",33,1986,38,0,0,0,0,0,0,1,0,1,0,0,0,0,0,10,1,"Matches","https://fbref.com/en/comps/9/2020-2021/defense/2020-2021-Premier-League-Stats"
"Giovani Lo Celso","Tottenham",2021,"ar ARG","MF",24,1996,10.5,28,22,12,11,5,10,29,34.5,19,12,1,11,7,35,5,0,"Matches","https://fbref.com/en/comps/9/2020-2021/defense/2020-2021-Premier-League-Stats"
"Ruben Loftus-Cheek","Chelsea",2021,"eng ENG","FW",24,1996,0.7,0,0,0,0,0,0,0,NA,0,0,0,0,0,0,0,0,"Matches","https://fbref.com/en/comps/9/2020-2021/defense/2020-2021-Premier-League-Stats"
"Ruben Loftus-Cheek","Fulham",2021,"eng ENG","MF,FW",24,1996,21.2,25,14,7,15,3,7,23,30.4,16,20,2,18,7,32,18,0,"Matches","https://fbref.com/en/comps/9/2020-2021/defense/2020-2021-Premier-League-Stats"
"Kevin Long","Burnley",2021,"ie IRL","DF",29,1990,7.1,11,6,9,2,0,7,9,77.8,2,11,7,4,6,17,24,0,"Matches","https://fbref.com/en/comps/9/2020-2021/defense/2020-2021-Premier-League-Stats"
"Shane Long","Southampton",2021,"ie IRL","FW",33,1987,2.3,2,1,0,0,2,2,3,66.7,1,0,0,0,3,5,1,0,"Matches","https://fbref.com/en/comps/9/2020-2021/defense/2020-2021-Premier-League-Stats"
"Matthew Longstaff","Newcastle Utd",2021,"eng ENG","MF",20,2000,4.2,3,2,2,1,0,2,8,25,6,7,0,7,7,10,2,0,"Matches","https://fbref.com/en/comps/9/2020-2021/defense/2020-2021-Premier-League-Stats"
"Sean Longstaff","Newcastle Utd",2021,"eng ENG","MF",22,1997,15.7,31,14,13,15,3,18,42,42.9,24,26,5,21,19,50,14,2,"Matches","https://fbref.com/en/comps/9/2020-2021/defense/2020-2021-Premier-League-Stats"
"Ademola Lookman","Fulham",2021,"ng NGA","FW,MF",22,1997,30.5,35,11,18,9,8,13,44,29.5,31,31,1,30,20,55,9,0,"Matches","https://fbref.com/en/comps/9/2020-2021/defense/2020-2021-Premier-League-Stats"
"Max Lowe","Sheffield Utd",2021,"eng ENG","DF",23,1997,6.1,26,11,18,6,2,9,21,42.9,12,12,4,8,5,31,11,0,"Matches","https://fbref.com/en/comps/9/2020-2021/defense/2020-2021-Premier-League-Stats"
"Matthew Lowton","Burnley",2021,"eng ENG","DF",31,1989,34,54,32,31,22,1,32,73,43.8,41,36,13,23,56,110,91,1,"Matches","https://fbref.com/en/comps/9/2020-2021/defense/2020-2021-Premier-League-Stats"
"David Luiz","Arsenal",2021,"br BRA","DF",33,1987,15.5,12,9,5,7,0,4,4,100,0,16,9,7,16,28,50,2,"Matches","https://fbref.com/en/comps/9/2020-2021/defense/2020-2021-Premier-League-Stats"
"Douglas Luiz","Aston Villa",2021,"br BRA","MF",22,1998,30.9,49,18,22,26,1,20,58,34.5,38,52,17,35,43,92,44,2,"Matches","https://fbref.com/en/comps/9/2020-2021/defense/2020-2021-Premier-League-Stats"
"John Lundstram","Sheffield Utd",2021,"eng ENG","MF",26,1994,22.6,25,16,12,11,2,13,47,27.7,34,26,8,18,14,39,29,1,"Matches","https://fbref.com/en/comps/9/2020-2021/defense/2020-2021-Premier-League-Stats"
"Alexis Mac Allister","Brighton",2021,"ar ARG","MF,FW",21,1998,12.4,26,12,6,16,4,11,38,28.9,27,25,4,21,9,35,4,0,"Matches","https://fbref.com/en/comps/9/2020-2021/defense/2020-2021-Premier-League-Stats"
"James Maddison","Leicester City",2021,"eng ENG","MF",23,1996,23.3,32,16,5,16,11,14,41,34.1,27,14,1,13,9,41,5,0,"Matches","https://fbref.com/en/comps/9/2020-2021/defense/2020-2021-Premier-League-Stats"
"Harry Maguire","Manchester Utd",2021,"eng ENG","DF",27,1993,33.9,29,17,19,10,0,18,29,62.1,11,28,23,5,60,89,122,4,"Matches","https://fbref.com/en/comps/9/2020-2021/defense/2020-2021-Premier-League-Stats"
"Riyad Mahrez","Manchester City",2021,"dz ALG","FW",29,1991,21.7,20,5,2,10,8,6,30,20,24,19,0,19,8,28,4,0,"Matches","https://fbref.com/en/comps/9/2020-2021/defense/2020-2021-Premier-League-Stats"
"Ainsley Maitland-Niles","Arsenal",2021,"eng ENG","MF,DF",22,1997,5.4,11,7,6,5,0,8,12,66.7,4,12,2,10,14,25,7,1,"Matches","https://fbref.com/en/comps/9/2020-2021/defense/2020-2021-Premier-League-Stats"
"Ainsley Maitland-Niles","West Brom",2021,"eng ENG","MF",22,1997,13.7,22,10,7,8,7,9,28,32.1,19,12,1,11,17,39,24,0,"Matches","https://fbref.com/en/comps/9/2020-2021/defense/2020-2021-Premier-League-Stats"
"Josh Maja","Fulham",2021,"ng NGA","FW",21,1998,9,7,4,0,3,4,4,10,40,6,3,1,2,4,11,1,0,"Matches","https://fbref.com/en/comps/9/2020-2021/defense/2020-2021-Premier-League-Stats"
"Sadio Mané","Liverpool",2021,"sn SEN","FW",28,1992,31.2,48,30,6,22,20,12,33,36.4,21,30,0,30,15,63,11,0,"Matches","https://fbref.com/en/comps/9/2020-2021/defense/2020-2021-Premier-League-Stats"
"Javier Manquillo","Newcastle Utd",2021,"es ESP","DF",26,1994,9.2,24,14,8,14,2,11,17,64.7,6,8,1,7,9,33,15,1,"Matches","https://fbref.com/en/comps/9/2020-2021/defense/2020-2021-Premier-League-Stats"
"Fernando Marçal","Wolves",2021,"br BRA","DF,MF",31,1989,6.9,13,5,6,7,0,6,11,54.5,5,11,2,9,12,25,25,0,"Matches","https://fbref.com/en/comps/9/2020-2021/defense/2020-2021-Premier-League-Stats"
"Solly March","Brighton",2021,"eng ENG","DF,MF",26,1994,18.6,49,23,24,15,10,18,34,52.9,16,30,5,25,22,71,30,0,"Matches","https://fbref.com/en/comps/9/2020-2021/defense/2020-2021-Premier-League-Stats"
"Pablo Marí","Arsenal",2021,"es ESP","DF",26,1993,10,15,9,12,3,0,5,10,50,5,8,7,1,9,24,30,2,"Matches","https://fbref.com/en/comps/9/2020-2021/defense/2020-2021-Premier-League-Stats"
"Anthony Martial","Manchester Utd",2021,"fr FRA","FW",24,1995,16.4,2,1,1,1,0,0,10,0,10,17,3,14,1,3,8,0,"Matches","https://fbref.com/en/comps/9/2020-2021/defense/2020-2021-Premier-League-Stats"
"Martinelli","Arsenal",2021,"br BRA","FW",19,2001,6.5,7,1,2,3,2,4,10,40,6,6,0,6,8,15,4,0,"Matches","https://fbref.com/en/comps/9/2020-2021/defense/2020-2021-Premier-League-Stats"
"Emiliano Martínez","Aston Villa",2021,"ar ARG","GK",27,1992,38,3,3,3,0,0,3,4,75,1,0,0,0,2,5,10,2,"Matches","https://fbref.com/en/comps/9/2020-2021/defense/2020-2021-Premier-League-Stats"
"Arthur Masuaku","West Ham",2021,"cd COD","DF,MF",26,1993,11.2,20,12,14,6,0,11,34,32.4,23,12,0,12,8,28,28,2,"Matches","https://fbref.com/en/comps/9/2020-2021/defense/2020-2021-Premier-League-Stats"
"Juan Mata","Manchester Utd",2021,"es ESP","FW,MF",32,1988,5.7,1,0,1,0,0,0,7,0,7,3,0,3,3,4,3,0,"Matches","https://fbref.com/en/comps/9/2020-2021/defense/2020-2021-Premier-League-Stats"
"Jean-Philippe Mateta","Crystal Palace",2021,"fr FRA","FW",23,1997,2.5,1,1,0,1,0,1,3,33.3,2,1,0,1,0,1,2,0,"Matches","https://fbref.com/en/comps/9/2020-2021/defense/2020-2021-Premier-League-Stats"
"Nemanja Matic","Manchester Utd",2021,"rs SRB","MF",31,1988,12.3,25,11,13,12,0,13,31,41.9,18,19,5,14,22,47,10,3,"Matches","https://fbref.com/en/comps/9/2020-2021/defense/2020-2021-Premier-League-Stats"
"Joël Matip","Liverpool",2021,"cm CMR","DF",28,1991,7.7,14,9,7,7,0,7,8,87.5,1,6,0,6,7,21,22,0,"Matches","https://fbref.com/en/comps/9/2020-2021/defense/2020-2021-Premier-League-Stats"
"Neal Maupay","Brighton",2021,"fr FRA","FW,MF",23,1996,27.9,20,8,9,7,4,4,24,16.7,20,20,0,20,13,33,6,0,"Matches","https://fbref.com/en/comps/9/2020-2021/defense/2020-2021-Premier-League-Stats"
"James McArthur","Crystal Palace",2021,"sct SCO","MF",32,1987,16.3,57,32,25,27,5,15,39,38.5,24,28,3,25,23,80,31,0,"Matches","https://fbref.com/en/comps/9/2020-2021/defense/2020-2021-Premier-League-Stats"
"Oliver McBurnie","Sheffield Utd",2021,"sct SCO","FW",24,1996,14.7,15,7,7,7,1,5,17,29.4,12,10,3,7,6,21,30,0,"Matches","https://fbref.com/en/comps/9/2020-2021/defense/2020-2021-Premier-League-Stats"
"Alex McCarthy","Southampton",2021,"eng ENG","GK",30,1989,30,1,0,1,0,0,1,4,25,3,0,0,0,0,1,11,1,"Matches","https://fbref.com/en/comps/9/2020-2021/defense/2020-2021-Premier-League-Stats"
"James McCarthy","Crystal Palace",2021,"ie IRL","MF",29,1990,9.1,16,12,9,7,0,8,21,38.1,13,15,7,8,8,24,12,0,"Matches","https://fbref.com/en/comps/9/2020-2021/defense/2020-2021-Premier-League-Stats"
"John McGinn","Aston Villa",2021,"sct SCO","MF",25,1994,37,61,37,23,31,7,27,84,32.1,57,38,6,32,43,104,23,2,"Matches","https://fbref.com/en/comps/9/2020-2021/defense/2020-2021-Premier-League-Stats"
"David McGoldrick","Sheffield Utd",2021,"ie IRL","FW,MF",32,1987,26.6,33,21,8,15,10,13,31,41.9,18,19,3,16,2,35,25,0,"Matches","https://fbref.com/en/comps/9/2020-2021/defense/2020-2021-Premier-League-Stats"
"Dwight McNeil","Burnley",2021,"eng ENG","MF",20,1999,34.1,47,24,24,18,5,18,56,32.1,38,44,6,38,32,79,32,1,"Matches","https://fbref.com/en/comps/9/2020-2021/defense/2020-2021-Premier-League-Stats"
"Scott McTominay","Manchester Utd",2021,"sct SCO","MF",23,1996,23.7,51,24,23,25,3,23,36,63.9,13,35,10,25,29,80,46,0,"Matches","https://fbref.com/en/comps/9/2020-2021/defense/2020-2021-Premier-League-Stats"
"Ben Mee","Burnley",2021,"eng ENG","DF",30,1989,29.9,32,15,16,14,2,14,29,48.3,15,54,45,9,43,75,148,2,"Matches","https://fbref.com/en/comps/9/2020-2021/defense/2020-2021-Premier-League-Stats"
"Hannibal Mejbri","Manchester Utd",2021,"tn TUN","MF",17,2003,0.1,0,0,0,0,0,0,0,NA,0,0,0,0,0,0,0,0,"Matches","https://fbref.com/en/comps/9/2020-2021/defense/2020-2021-Premier-League-Stats"
"Benjamin Mendy","Manchester City",2021,"fr FRA","DF",26,1994,10.6,13,9,1,8,4,5,21,23.8,16,12,5,7,5,18,14,1,"Matches","https://fbref.com/en/comps/9/2020-2021/defense/2020-2021-Premier-League-Stats"
"Edouard Mendy","Chelsea",2021,"sn SEN","GK",28,1992,30.5,0,0,0,0,0,0,1,0,1,0,0,0,1,1,9,3,"Matches","https://fbref.com/en/comps/9/2020-2021/defense/2020-2021-Premier-League-Stats"
"Nampalys Mendy","Leicester City",2021,"sn SEN","MF",28,1992,16.2,26,17,18,6,2,7,20,35,13,12,1,11,14,40,8,0,"Matches","https://fbref.com/en/comps/9/2020-2021/defense/2020-2021-Premier-League-Stats"
"Illan Meslier","Leeds United",2021,"fr FRA","GK",20,2000,35,0,0,0,0,0,0,1,0,1,0,0,0,0,0,17,8,"Matches","https://fbref.com/en/comps/9/2020-2021/defense/2020-2021-Premier-League-Stats"
"Luka Milivojevic","Crystal Palace",2021,"rs SRB","MF",29,1991,26.2,65,34,25,31,9,42,77,54.5,35,29,6,23,35,100,47,2,"Matches","https://fbref.com/en/comps/9/2020-2021/defense/2020-2021-Premier-League-Stats"
"James Milner","Liverpool",2021,"eng ENG","MF,DF",34,1986,11.9,26,19,9,14,3,11,33,33.3,22,30,3,27,14,40,16,1,"Matches","https://fbref.com/en/comps/9/2020-2021/defense/2020-2021-Premier-League-Stats"
"Yerry Mina","Everton",2021,"co COL","DF",25,1994,21.5,21,14,17,4,0,8,12,66.7,4,30,23,7,24,45,110,1,"Matches","https://fbref.com/en/comps/9/2020-2021/defense/2020-2021-Premier-League-Stats"
"Takumi Minamino","Southampton",2021,"jp JPN","MF",25,1995,7.9,7,3,2,5,0,2,19,10.5,17,13,1,12,4,11,9,0,"Matches","https://fbref.com/en/comps/9/2020-2021/defense/2020-2021-Premier-League-Stats"
"Takumi Minamino","Liverpool",2021,"jp JPN","MF,FW",25,1995,3.3,4,3,1,2,1,0,12,0,12,1,0,1,2,6,3,0,"Matches","https://fbref.com/en/comps/9/2020-2021/defense/2020-2021-Premier-League-Stats"
"Tyrone Mings","Aston Villa",2021,"eng ENG","DF",27,1993,35.5,32,16,23,7,2,16,24,66.7,8,59,40,19,41,73,172,3,"Matches","https://fbref.com/en/comps/9/2020-2021/defense/2020-2021-Premier-League-Stats"
"Tyrick Mitchell","Crystal Palace",2021,"eng ENG","DF",20,1999,19,64,35,48,9,7,23,40,57.5,17,29,10,19,21,85,62,1,"Matches","https://fbref.com/en/comps/9/2020-2021/defense/2020-2021-Premier-League-Stats"
"Aleksandar Mitrovic","Fulham",2021,"rs SRB","FW",25,1994,15.6,7,4,0,3,4,2,8,25,6,12,3,9,3,10,8,0,"Matches","https://fbref.com/en/comps/9/2020-2021/defense/2020-2021-Premier-League-Stats"
"Jakub Moder","Brighton",2021,"pl POL","DF,MF",21,1999,7.2,15,7,5,7,3,7,20,35,13,12,1,11,3,18,9,0,"Matches","https://fbref.com/en/comps/9/2020-2021/defense/2020-2021-Premier-League-Stats"
"Jayson Molumby","Brighton",2021,"ie IRL","MF",20,1999,0,0,0,0,0,0,0,0,NA,0,0,0,0,0,0,0,0,"Matches","https://fbref.com/en/comps/9/2020-2021/defense/2020-2021-Premier-League-Stats"
"Wesley Moraes","Aston Villa",2021,"br BRA","FW",23,1996,0.2,0,0,0,0,0,0,1,0,1,0,0,0,0,0,0,0,"Matches","https://fbref.com/en/comps/9/2020-2021/defense/2020-2021-Premier-League-Stats"
"Wes Morgan","Leicester City",2021,"jm JAM","DF",36,1984,0.2,0,0,0,0,0,0,0,NA,0,0,0,0,0,0,1,0,"Matches","https://fbref.com/en/comps/9/2020-2021/defense/2020-2021-Premier-League-Stats"
"Mason Mount","Chelsea",2021,"eng ENG","MF",21,1999,32.1,75,35,22,38,15,25,69,36.2,44,40,2,38,31,106,14,0,"Matches","https://fbref.com/en/comps/9/2020-2021/defense/2020-2021-Premier-League-Stats"
"Lucas Moura","Tottenham",2021,"br BRA","FW,MF",27,1992,15.7,32,16,12,16,4,8,29,27.6,21,12,0,12,18,50,10,0,"Matches","https://fbref.com/en/comps/9/2020-2021/defense/2020-2021-Premier-League-Stats"
"Lys Mousset","Sheffield Utd",2021,"fr FRA","FW,MF",24,1996,3.3,1,0,0,0,1,0,2,0,2,1,0,1,0,1,1,1,"Matches","https://fbref.com/en/comps/9/2020-2021/defense/2020-2021-Premier-League-Stats"
"João Moutinho","Wolves",2021,"pt POR","MF",33,1986,28.1,75,40,34,35,6,35,91,38.5,56,18,3,15,47,122,28,0,"Matches","https://fbref.com/en/comps/9/2020-2021/defense/2020-2021-Premier-League-Stats"
"Joel Mumbongo","Burnley",2021,"se SWE","FW",21,1999,0.4,0,0,0,0,0,0,0,NA,0,1,0,1,0,0,0,0,"Matches","https://fbref.com/en/comps/9/2020-2021/defense/2020-2021-Premier-League-Stats"
"Jacob Murphy","Newcastle Utd",2021,"eng ENG","DF,MF",25,1995,18.1,39,24,25,12,2,24,49,49,25,27,3,24,14,53,29,0,"Matches","https://fbref.com/en/comps/9/2020-2021/defense/2020-2021-Premier-League-Stats"
"Shkodran Mustafi","Arsenal",2021,"de GER","DF",28,1992,0.5,1,1,1,0,0,1,1,100,0,1,0,1,0,1,3,0,"Matches","https://fbref.com/en/comps/9/2020-2021/defense/2020-2021-Premier-League-Stats"
"Marvelous Nakamba","Aston Villa",2021,"zw ZIM","MF",26,1994,8.3,22,14,10,11,1,7,12,58.3,5,16,5,11,17,39,9,1,"Matches","https://fbref.com/en/comps/9/2020-2021/defense/2020-2021-Premier-League-Stats"
"Iliman Ndiaye","Sheffield Utd",2021,"sn SEN","MF",20,2000,0.1,1,1,0,1,0,1,1,100,0,0,0,0,0,1,0,0,"Matches","https://fbref.com/en/comps/9/2020-2021/defense/2020-2021-Premier-League-Stats"
"Wilfred Ndidi","Leicester City",2021,"ng NGA","MF,DF",23,1996,24.2,96,63,45,44,7,26,66,39.4,40,38,11,27,61,157,55,0,"Matches","https://fbref.com/en/comps/9/2020-2021/defense/2020-2021-Premier-League-Stats"
"Tanguy Ndombele","Tottenham",2021,"fr FRA","MF",23,1996,23.2,41,20,11,21,9,18,44,40.9,26,28,4,24,19,60,15,0,"Matches","https://fbref.com/en/comps/9/2020-2021/defense/2020-2021-Premier-League-Stats"
"Reiss Nelson","Arsenal",2021,"eng ENG","FW,MF",20,1999,0.8,1,0,0,0,1,0,0,NA,0,0,0,0,1,2,1,0,"Matches","https://fbref.com/en/comps/9/2020-2021/defense/2020-2021-Premier-League-Stats"
"Pedro Neto","Wolves",2021,"pt POR","FW,MF",20,2000,28.3,16,9,4,6,6,6,28,21.4,22,18,2,16,31,47,8,0,"Matches","https://fbref.com/en/comps/9/2020-2021/defense/2020-2021-Premier-League-Stats"
"Rúben Neves","Wolves",2021,"pt POR","MF",23,1997,29.7,86,46,42,38,6,36,88,40.9,52,55,11,44,65,151,46,2,"Matches","https://fbref.com/en/comps/9/2020-2021/defense/2020-2021-Premier-League-Stats"
"Eddie Nketiah","Arsenal",2021,"eng ENG","FW",21,1999,4.7,3,1,0,2,1,0,2,0,2,6,0,6,0,3,5,0,"Matches","https://fbref.com/en/comps/9/2020-2021/defense/2020-2021-Premier-League-Stats"
"Niels Nkounkou","Everton",2021,"fr FRA","DF,FW",19,2000,0.9,4,3,1,2,1,3,8,37.5,5,4,0,4,0,4,4,0,"Matches","https://fbref.com/en/comps/9/2020-2021/defense/2020-2021-Premier-League-Stats"
"Dan Nlundulu","Southampton",2021,"eng ENG","FW,MF",21,1999,1.2,0,0,0,0,0,0,1,0,1,2,0,2,0,0,2,0,"Matches","https://fbref.com/en/comps/9/2020-2021/defense/2020-2021-Premier-League-Stats"
"Mark Noble","West Ham",2021,"eng ENG","MF",33,1987,7.9,8,4,2,5,1,4,14,28.6,10,7,3,4,13,21,3,0,"Matches","https://fbref.com/en/comps/9/2020-2021/defense/2020-2021-Premier-League-Stats"
"Will Norris","Burnley",2021,"eng ENG","GK",26,1993,2,0,0,0,0,0,0,0,NA,0,0,0,0,0,0,0,0,"Matches","https://fbref.com/en/comps/9/2020-2021/defense/2020-2021-Premier-League-Stats"
"Oliver Norwood","Sheffield Utd",2021,"nir NIR","MF",29,1991,24.7,49,22,16,28,5,21,72,29.2,51,29,12,17,36,85,51,1,"Matches","https://fbref.com/en/comps/9/2020-2021/defense/2020-2021-Premier-League-Stats"
"Jack O'Connell","Sheffield Utd",2021,"eng ENG","DF",26,1994,2,3,1,1,1,1,0,1,0,1,4,3,1,2,5,7,0,"Matches","https://fbref.com/en/comps/9/2020-2021/defense/2020-2021-Premier-League-Stats"
"Dara O'Shea","West Brom",2021,"ie IRL","DF",21,1999,23.4,45,25,30,13,2,21,45,46.7,24,32,17,15,45,90,108,0,"Matches","https://fbref.com/en/comps/9/2020-2021/defense/2020-2021-Premier-League-Stats"
"Michael Obafemi","Southampton",2021,"ie IRL","FW",20,2000,0.7,1,0,0,1,0,0,1,0,1,1,0,1,0,1,0,0,"Matches","https://fbref.com/en/comps/9/2020-2021/defense/2020-2021-Premier-League-Stats"
"Denis Odoi","Fulham",2021,"gh GHA","DF",32,1988,3,3,3,2,1,0,1,4,25,3,3,1,2,5,8,5,0,"Matches","https://fbref.com/en/comps/9/2020-2021/defense/2020-2021-Premier-League-Stats"
"Angelo Ogbonna","West Ham",2021,"it ITA","DF",32,1988,27.7,26,13,20,5,1,9,17,52.9,8,25,11,14,30,56,119,0,"Matches","https://fbref.com/en/comps/9/2020-2021/defense/2020-2021-Premier-League-Stats"
"Robin Olsen","Everton",2021,"se SWE","GK",30,1990,7,0,0,0,0,0,0,0,NA,0,0,0,0,0,0,4,1,"Matches","https://fbref.com/en/comps/9/2020-2021/defense/2020-2021-Premier-League-Stats"
"Josh Onomah","Fulham",2021,"eng ENG","MF",23,1997,4.2,11,8,1,6,4,0,5,0,5,4,2,2,2,13,1,0,"Matches","https://fbref.com/en/comps/9/2020-2021/defense/2020-2021-Premier-League-Stats"
"Divock Origi","Liverpool",2021,"be BEL","FW",25,1995,2.1,3,2,0,2,1,1,3,33.3,2,5,1,4,1,4,2,0,"Matches","https://fbref.com/en/comps/9/2020-2021/defense/2020-2021-Premier-League-Stats"
"Ben Osborn","Sheffield Utd",2021,"eng ENG","MF,DF",25,1994,17.8,33,18,15,10,8,13,40,32.5,27,20,3,17,12,45,17,0,"Matches","https://fbref.com/en/comps/9/2020-2021/defense/2020-2021-Premier-League-Stats"
"Owen Otasowie","Wolves",2021,"us USA","MF,FW",19,2001,2.1,5,5,3,2,0,1,2,50,1,1,1,0,3,8,4,0,"Matches","https://fbref.com/en/comps/9/2020-2021/defense/2020-2021-Premier-League-Stats"
"Alex Oxlade-Chamberlain","Liverpool",2021,"eng ENG","MF,FW",26,1993,2.8,4,0,0,3,1,0,2,0,2,1,0,1,2,6,0,0,"Matches","https://fbref.com/en/comps/9/2020-2021/defense/2020-2021-Premier-League-Stats"
"Emerson Palmieri","Chelsea",2021,"it ITA","DF",25,1994,1,3,3,2,0,1,1,3,33.3,2,0,0,0,1,4,6,0,"Matches","https://fbref.com/en/comps/9/2020-2021/defense/2020-2021-Premier-League-Stats"
"Thomas Partey","Arsenal",2021,"gh GHA","MF",27,1993,17,44,21,16,24,4,24,56,42.9,32,17,5,12,23,67,18,0,"Matches","https://fbref.com/en/comps/9/2020-2021/defense/2020-2021-Premier-League-Stats"
"Rui Patrício","Wolves",2021,"pt POR","GK",32,1988,37,0,0,0,0,0,0,1,0,1,0,0,0,1,1,3,3,"Matches","https://fbref.com/en/comps/9/2020-2021/defense/2020-2021-Premier-League-Stats"
"Bailey Peacock-Farrell","Burnley",2021,"nir NIR","GK",23,1996,4,0,0,0,0,0,0,0,NA,0,0,0,0,0,0,0,0,"Matches","https://fbref.com/en/comps/9/2020-2021/defense/2020-2021-Premier-League-Stats"
"Lee Peltier","West Brom",2021,"eng ENG","DF",33,1986,2.5,9,4,8,1,0,4,4,100,0,1,1,0,1,10,11,0,"Matches","https://fbref.com/en/comps/9/2020-2021/defense/2020-2021-Premier-League-Stats"
"Nicolas Pépé","Arsenal",2021,"ci CIV","FW",25,1995,18,20,15,8,6,6,8,23,34.8,15,16,1,15,12,32,19,0,"Matches","https://fbref.com/en/comps/9/2020-2021/defense/2020-2021-Premier-League-Stats"
"Matheus Pereira","West Brom",2021,"pt POR","MF,FW",24,1996,28.6,26,15,14,10,2,12,54,22.2,42,18,0,18,29,55,16,0,"Matches","https://fbref.com/en/comps/9/2020-2021/defense/2020-2021-Premier-League-Stats"
"Ricardo Pereira","Leicester City",2021,"pt POR","DF,FW",26,1993,10.7,31,22,16,8,7,14,35,40,21,24,1,23,15,46,23,0,"Matches","https://fbref.com/en/comps/9/2020-2021/defense/2020-2021-Premier-League-Stats"
"Ayoze Pérez","Leicester City",2021,"es ESP","MF,FW",27,1993,14.8,32,15,6,20,6,13,48,27.1,35,28,0,28,10,42,7,0,"Matches","https://fbref.com/en/comps/9/2020-2021/defense/2020-2021-Premier-League-Stats"
"Kalvin Phillips","Leeds United",2021,"eng ENG","MF",24,1995,27,74,38,38,29,7,26,62,41.9,36,49,14,35,45,119,53,3,"Matches","https://fbref.com/en/comps/9/2020-2021/defense/2020-2021-Premier-League-Stats"
"Matt Phillips","West Brom",2021,"sct SCO","MF",29,1991,20.3,15,8,4,11,0,7,23,30.4,16,32,4,28,10,25,32,1,"Matches","https://fbref.com/en/comps/9/2020-2021/defense/2020-2021-Premier-League-Stats"
"Nathaniel Phillips","Liverpool",2021,"eng ENG","DF",23,1997,16.2,22,14,15,7,0,11,24,45.8,13,17,14,3,20,42,81,0,"Matches","https://fbref.com/en/comps/9/2020-2021/defense/2020-2021-Premier-League-Stats"
"Jaden Philogene Bidace","Aston Villa",2021,"eng ENG","FW",18,2002,0,0,0,0,0,0,0,0,NA,0,0,0,0,0,0,0,0,"Matches","https://fbref.com/en/comps/9/2020-2021/defense/2020-2021-Premier-League-Stats"
"Jordan Pickford","Everton",2021,"eng ENG","GK",26,1994,30.5,0,0,0,0,0,0,2,0,2,2,0,2,3,3,16,4,"Matches","https://fbref.com/en/comps/9/2020-2021/defense/2020-2021-Premier-League-Stats"
"Erik Pieters","Burnley",2021,"nl NED","DF,MF",31,1988,14.1,30,21,18,9,3,19,39,48.7,20,30,9,21,12,42,34,0,"Matches","https://fbref.com/en/comps/9/2020-2021/defense/2020-2021-Premier-League-Stats"
"Daniel Podence","Wolves",2021,"pt POR","MF,FW",24,1995,18.5,12,6,5,5,2,2,19,10.5,17,5,1,4,13,25,2,0,"Matches","https://fbref.com/en/comps/9/2020-2021/defense/2020-2021-Premier-League-Stats"
"Paul Pogba","Manchester Utd",2021,"fr FRA","MF,FW",27,1993,21.1,36,26,15,16,5,11,33,33.3,22,24,2,22,26,62,37,0,"Matches","https://fbref.com/en/comps/9/2020-2021/defense/2020-2021-Premier-League-Stats"
"Nick Pope","Burnley",2021,"eng ENG","GK",28,1992,32,1,1,1,0,0,0,1,0,1,0,0,0,2,3,29,2,"Matches","https://fbref.com/en/comps/9/2020-2021/defense/2020-2021-Premier-League-Stats"
"Dennis Praet","Leicester City",2021,"be BEL","MF",26,1994,8,14,7,4,7,3,6,15,40,9,12,2,10,7,21,3,0,"Matches","https://fbref.com/en/comps/9/2020-2021/defense/2020-2021-Premier-League-Stats"
"Davy Pröpper","Brighton",2021,"nl NED","MF",28,1991,2.4,6,5,0,6,0,2,5,40,3,3,0,3,1,7,0,0,"Matches","https://fbref.com/en/comps/9/2020-2021/defense/2020-2021-Premier-League-Stats"
"Christian Pulisic","Chelsea",2021,"us USA","FW,MF",21,1998,19.3,19,11,8,10,1,8,21,38.1,13,25,2,23,12,31,9,0,"Matches","https://fbref.com/en/comps/9/2020-2021/defense/2020-2021-Premier-League-Stats"
"Aaron Ramsdale","Sheffield Utd",2021,"eng ENG","GK",22,1998,38,1,1,1,0,0,1,1,100,0,0,0,0,2,3,22,6,"Matches","https://fbref.com/en/comps/9/2020-2021/defense/2020-2021-Premier-League-Stats"
"Jacob Ramsey","Aston Villa",2021,"eng ENG","MF",19,2001,7,10,5,3,4,3,2,12,16.7,10,13,6,7,4,14,5,0,"Matches","https://fbref.com/en/comps/9/2020-2021/defense/2020-2021-Premier-League-Stats"
"Kayne Ramsey","Southampton",2021,"eng ENG","DF",19,2000,1,5,2,4,1,0,3,3,100,0,0,0,0,0,5,3,0,"Matches","https://fbref.com/en/comps/9/2020-2021/defense/2020-2021-Premier-League-Stats"
"Darren Randolph","West Ham",2021,"ie IRL","GK",33,1987,3,0,0,0,0,0,0,0,NA,0,0,0,0,0,0,1,0,"Matches","https://fbref.com/en/comps/9/2020-2021/defense/2020-2021-Premier-League-Stats"
"Raphinha","Leeds United",2021,"br BRA","MF,FW",23,1996,26.2,34,17,13,16,5,12,58,20.7,46,31,1,30,29,63,27,0,"Matches","https://fbref.com/en/comps/9/2020-2021/defense/2020-2021-Premier-League-Stats"
"Marcus Rashford","Manchester Utd",2021,"eng ENG","FW",22,1997,32.4,18,9,2,8,8,7,27,25.9,20,22,2,20,8,26,10,0,"Matches","https://fbref.com/en/comps/9/2020-2021/defense/2020-2021-Premier-League-Stats"
"Tim Ream","Fulham",2021,"us USA","DF",32,1987,7,12,5,9,3,0,8,11,72.7,3,8,5,3,6,18,26,1,"Matches","https://fbref.com/en/comps/9/2020-2021/defense/2020-2021-Premier-League-Stats"
"Nathan Redmond","Southampton",2021,"eng ENG","MF,FW",26,1994,19.3,30,17,14,12,4,8,24,33.3,16,24,2,22,11,41,9,0,"Matches","https://fbref.com/en/comps/9/2020-2021/defense/2020-2021-Premier-League-Stats"
"Harrison Reed","Fulham",2021,"eng ENG","MF",25,1995,25,63,38,28,28,7,29,73,39.7,44,34,11,23,50,113,31,1,"Matches","https://fbref.com/en/comps/9/2020-2021/defense/2020-2021-Premier-League-Stats"
"Sergio Reguilón","Tottenham",2021,"es ESP","DF",23,1996,24.9,47,25,30,13,4,23,48,47.9,25,39,7,32,32,79,50,1,"Matches","https://fbref.com/en/comps/9/2020-2021/defense/2020-2021-Premier-League-Stats"
"Bobby Reid","Fulham",2021,"jm JAM","MF,FW",27,1993,26.4,31,15,17,10,4,18,39,46.2,21,19,5,14,21,52,39,0,"Matches","https://fbref.com/en/comps/9/2020-2021/defense/2020-2021-Premier-League-Stats"
"Declan Rice","West Ham",2021,"eng ENG","MF",21,1999,32,59,35,33,25,1,21,51,41.2,30,39,11,28,59,118,41,0,"Matches","https://fbref.com/en/comps/9/2020-2021/defense/2020-2021-Premier-League-Stats"
"Lewis Richardson","Burnley",2021,"eng ENG","FW,MF",17,2003,0,0,0,0,0,0,0,0,NA,0,0,0,0,0,0,0,0,"Matches","https://fbref.com/en/comps/9/2020-2021/defense/2020-2021-Premier-League-Stats"
"Richarlison","Everton",2021,"br BRA","FW",23,1997,31.8,50,32,21,22,7,16,51,31.4,35,28,3,25,14,64,36,1,"Matches","https://fbref.com/en/comps/9/2020-2021/defense/2020-2021-Premier-League-Stats"
"Jaïro Riedewald","Crystal Palace",2021,"nl NED","MF",23,1996,20.2,34,15,13,17,4,16,36,44.4,20,39,7,32,29,63,25,0,"Matches","https://fbref.com/en/comps/9/2020-2021/defense/2020-2021-Premier-League-Stats"
"Matt Ritchie","Newcastle Utd",2021,"sct SCO","DF,MF",30,1989,15,10,3,5,3,2,3,17,17.6,14,17,2,15,12,22,47,0,"Matches","https://fbref.com/en/comps/9/2020-2021/defense/2020-2021-Premier-League-Stats"
"Tyler Roberts","Leeds United",2021,"wls WAL","MF,FW",21,1999,14.9,15,13,1,11,3,5,22,22.7,17,17,2,15,9,24,12,0,"Matches","https://fbref.com/en/comps/9/2020-2021/defense/2020-2021-Premier-League-Stats"
"Andrew Robertson","Liverpool",2021,"sct SCO","DF",26,1994,37.6,46,34,23,18,5,28,57,49.1,29,39,9,30,21,67,79,1,"Matches","https://fbref.com/en/comps/9/2020-2021/defense/2020-2021-Premier-League-Stats"
"Antonee Robinson","Fulham",2021,"us USA","DF",22,1997,24,45,28,24,16,5,27,44,61.4,17,21,4,17,37,82,68,0,"Matches","https://fbref.com/en/comps/9/2020-2021/defense/2020-2021-Premier-League-Stats"
"Callum Robinson","West Brom",2021,"ie IRL","FW,MF",25,1995,17.3,7,5,5,1,1,3,19,15.8,16,9,0,9,7,14,8,0,"Matches","https://fbref.com/en/comps/9/2020-2021/defense/2020-2021-Premier-League-Stats"
"Jack Robinson","Sheffield Utd",2021,"eng ENG","DF",26,1993,9.7,14,6,8,5,1,6,11,54.5,5,10,4,6,9,23,42,0,"Matches","https://fbref.com/en/comps/9/2020-2021/defense/2020-2021-Premier-League-Stats"
"Hal Robson-Kanu","West Brom",2021,"wls WAL","FW",31,1989,6.2,2,1,1,0,1,0,1,0,1,2,0,2,2,4,7,0,"Matches","https://fbref.com/en/comps/9/2020-2021/defense/2020-2021-Premier-League-Stats"
"Marek Rodák","Fulham",2021,"sk SVK","GK",23,1996,2,0,0,0,0,0,0,0,NA,0,0,0,0,0,0,0,0,"Matches","https://fbref.com/en/comps/9/2020-2021/defense/2020-2021-Premier-League-Stats"
"Joe Rodon","Tottenham",2021,"wls WAL","DF",22,1997,8.1,14,9,11,2,1,3,4,75,1,10,8,2,21,35,36,2,"Matches","https://fbref.com/en/comps/9/2020-2021/defense/2020-2021-Premier-League-Stats"
"Rodri","Manchester City",2021,"es ESP","MF",24,1996,30.5,72,40,24,40,8,33,66,50,33,23,9,14,36,108,54,3,"Matches","https://fbref.com/en/comps/9/2020-2021/defense/2020-2021-Premier-League-Stats"
"Rodrigo","Leeds United",2021,"es ESP","MF,FW",29,1991,14.3,14,7,8,3,3,4,22,18.2,18,7,0,7,5,19,16,0,"Matches","https://fbref.com/en/comps/9/2020-2021/defense/2020-2021-Premier-League-Stats"
"James Rodríguez","Everton",2021,"co COL","FW,MF",29,1991,19.6,28,17,8,15,5,11,46,23.9,35,17,0,17,15,43,3,0,"Matches","https://fbref.com/en/comps/9/2020-2021/defense/2020-2021-Premier-League-Stats"
"Jay Rodriguez","Burnley",2021,"eng ENG","FW",31,1989,14.1,25,16,5,15,5,13,28,46.4,15,25,4,21,2,27,7,0,"Matches","https://fbref.com/en/comps/9/2020-2021/defense/2020-2021-Premier-League-Stats"
"Oriol Romeu","Southampton",2021,"es ESP","MF",28,1991,19.6,69,35,25,39,5,26,68,38.2,42,28,7,21,30,99,18,0,"Matches","https://fbref.com/en/comps/9/2020-2021/defense/2020-2021-Premier-League-Stats"
"John Ruddy","Wolves",2021,"eng ENG","GK",33,1986,1,0,0,0,0,0,0,0,NA,0,0,0,0,0,0,0,0,"Matches","https://fbref.com/en/comps/9/2020-2021/defense/2020-2021-Premier-League-Stats"
"Antonio Rüdiger","Chelsea",2021,"de GER","DF",27,1993,19,31,23,16,14,1,12,15,80,3,17,10,7,18,49,51,0,"Matches","https://fbref.com/en/comps/9/2020-2021/defense/2020-2021-Premier-League-Stats"
"Mathew Ryan","Arsenal",2021,"au AUS","GK",28,1992,3,0,0,0,0,0,0,0,NA,0,0,0,0,0,0,1,0,"Matches","https://fbref.com/en/comps/9/2020-2021/defense/2020-2021-Premier-League-Stats"
"Mathew Ryan","Brighton",2021,"au AUS","GK",28,1992,11,1,0,1,0,0,0,0,NA,0,0,0,0,0,1,4,0,"Matches","https://fbref.com/en/comps/9/2020-2021/defense/2020-2021-Premier-League-Stats"
"Allan Saint-Maximin","Newcastle Utd",2021,"fr FRA","FW,MF",23,1997,17.3,16,9,6,9,1,4,9,44.4,5,10,0,10,4,20,2,0,"Matches","https://fbref.com/en/comps/9/2020-2021/defense/2020-2021-Premier-League-Stats"
"Romain Saïss","Wolves",2021,"ma MAR","DF",30,1990,26.7,35,24,23,12,0,19,33,57.6,14,28,13,15,52,87,115,1,"Matches","https://fbref.com/en/comps/9/2020-2021/defense/2020-2021-Premier-League-Stats"
"Bukayo Saka","Arsenal",2021,"eng ENG","FW,MF",18,2001,28.4,25,16,10,13,2,11,40,27.5,29,21,2,19,25,50,24,0,"Matches","https://fbref.com/en/comps/9/2020-2021/defense/2020-2021-Premier-League-Stats"
"Mamadou Sakho","Crystal Palace",2021,"fr FRA","DF",30,1990,3.1,3,2,1,2,0,3,3,100,0,3,2,1,3,6,11,0,"Matches","https://fbref.com/en/comps/9/2020-2021/defense/2020-2021-Premier-League-Stats"
"Mohamed Salah","Liverpool",2021,"eg EGY","FW",28,1992,34.2,18,9,4,4,10,7,16,43.8,9,10,0,10,1,19,10,1,"Matches","https://fbref.com/en/comps/9/2020-2021/defense/2020-2021-Premier-League-Stats"
"Mohammed Salisu","Southampton",2021,"gh GHA","DF",21,1999,9.4,38,21,20,16,2,25,34,73.5,9,22,5,17,17,55,30,0,"Matches","https://fbref.com/en/comps/9/2020-2021/defense/2020-2021-Premier-League-Stats"
"Davinson Sánchez","Tottenham",2021,"co COL","DF",24,1996,16.5,40,20,31,9,0,21,32,65.6,11,18,13,5,14,54,85,2,"Matches","https://fbref.com/en/comps/9/2020-2021/defense/2020-2021-Premier-League-Stats"
"Robert Sánchez","Brighton",2021,"es ESP","GK",22,1997,27,1,0,1,0,0,1,1,100,0,1,0,1,1,2,11,2,"Matches","https://fbref.com/en/comps/9/2020-2021/defense/2020-2021-Premier-League-Stats"
"Morgan Sanson","Aston Villa",2021,"fr FRA","MF",25,1994,3.3,7,4,4,2,1,1,4,25,3,5,0,5,4,11,1,0,"Matches","https://fbref.com/en/comps/9/2020-2021/defense/2020-2021-Premier-League-Stats"
"Romaine Sawyers","West Brom",2021,"kn SKN","MF",28,1991,16.5,30,18,16,12,2,14,43,32.6,29,20,4,16,18,48,12,3,"Matches","https://fbref.com/en/comps/9/2020-2021/defense/2020-2021-Premier-League-Stats"
"Dane Scarlett","Tottenham",2021,"eng ENG","FW",16,2004,0,0,0,0,0,0,0,0,NA,0,0,0,0,0,0,0,0,"Matches","https://fbref.com/en/comps/9/2020-2021/defense/2020-2021-Premier-League-Stats"
"Fabian Schär","Newcastle Utd",2021,"ch SUI","DF",28,1991,13.8,13,4,8,5,0,7,19,36.8,12,19,12,7,27,40,52,1,"Matches","https://fbref.com/en/comps/9/2020-2021/defense/2020-2021-Premier-League-Stats"
"Jeffrey Schlupp","Crystal Palace",2021,"gh GHA","MF",27,1992,15.9,29,16,14,12,3,6,23,26.1,17,24,8,16,22,51,16,0,"Matches","https://fbref.com/en/comps/9/2020-2021/defense/2020-2021-Premier-League-Stats"
"Kasper Schmeichel","Leicester City",2021,"dk DEN","GK",33,1986,38,0,0,0,0,0,0,0,NA,0,0,0,0,0,0,10,0,"Matches","https://fbref.com/en/comps/9/2020-2021/defense/2020-2021-Premier-League-Stats"
"Nélson Semedo","Wolves",2021,"pt POR","DF,MF",26,1993,33.1,85,48,53,23,9,42,72,58.3,30,30,10,20,41,126,78,2,"Matches","https://fbref.com/en/comps/9/2020-2021/defense/2020-2021-Premier-League-Stats"
"Femi Seriki","Sheffield Utd",2021,"eng ENG","MF",18,2002,0,0,0,0,0,0,0,0,NA,0,0,0,0,0,0,0,0,"Matches","https://fbref.com/en/comps/9/2020-2021/defense/2020-2021-Premier-League-Stats"
"Jamie Shackleton","Leeds United",2021,"eng ENG","MF,DF",20,1999,5.1,10,6,6,4,0,4,11,36.4,7,3,1,2,9,19,3,0,"Matches","https://fbref.com/en/comps/9/2020-2021/defense/2020-2021-Premier-League-Stats"
"Xherdan Shaqiri","Liverpool",2021,"ch SUI","MF,FW",28,1991,6.2,7,4,3,1,3,2,7,28.6,5,4,0,4,2,9,0,0,"Matches","https://fbref.com/en/comps/9/2020-2021/defense/2020-2021-Premier-League-Stats"
"Billy Sharp","Sheffield Utd",2021,"eng ENG","FW",34,1986,8.2,5,1,0,3,2,2,9,22.2,7,2,0,2,0,5,2,0,"Matches","https://fbref.com/en/comps/9/2020-2021/defense/2020-2021-Premier-League-Stats"
"Luke Shaw","Manchester Utd",2021,"eng ENG","DF",25,1995,29.5,44,28,21,16,7,21,36,58.3,15,34,9,25,20,64,44,2,"Matches","https://fbref.com/en/comps/9/2020-2021/defense/2020-2021-Premier-League-Stats"
"Jonjo Shelvey","Newcastle Utd",2021,"eng ENG","MF",28,1992,29.1,39,14,18,19,2,10,37,27,27,26,14,12,36,75,42,0,"Matches","https://fbref.com/en/comps/9/2020-2021/defense/2020-2021-Premier-League-Stats"
"Shola Shoretire","Manchester Utd",2021,"eng ENG","FW",16,2004,0.1,0,0,0,0,0,0,0,NA,0,0,0,0,0,0,0,0,"Matches","https://fbref.com/en/comps/9/2020-2021/defense/2020-2021-Premier-League-Stats"
"Gylfi Sigurðsson","Everton",2021,"is ISL","MF,FW",30,1989,25,30,20,9,14,7,13,44,29.5,31,31,2,29,34,64,21,1,"Matches","https://fbref.com/en/comps/9/2020-2021/defense/2020-2021-Premier-League-Stats"
"Bernardo Silva","Manchester City",2021,"pt POR","MF,FW",25,1994,22.9,26,14,7,12,7,11,52,21.2,41,17,1,16,17,43,8,0,"Matches","https://fbref.com/en/comps/9/2020-2021/defense/2020-2021-Premier-League-Stats"
"Fábio Silva","Wolves",2021,"pt POR","FW",18,2002,15.2,6,4,1,4,1,4,12,33.3,8,12,1,11,4,10,5,1,"Matches","https://fbref.com/en/comps/9/2020-2021/defense/2020-2021-Premier-League-Stats"
"Thiago Silva","Chelsea",2021,"br BRA","DF",35,1984,21.5,20,12,11,8,1,14,21,66.7,7,21,13,8,33,53,86,1,"Matches","https://fbref.com/en/comps/9/2020-2021/defense/2020-2021-Premier-League-Stats"
"Moussa Sissoko","Tottenham",2021,"fr FRA","MF",30,1989,17.6,22,16,19,3,0,8,20,40,12,11,4,7,23,45,25,0,"Matches","https://fbref.com/en/comps/9/2020-2021/defense/2020-2021-Premier-League-Stats"
"Islam Slimani","Leicester City",2021,"dz ALG","FW",32,1988,0.2,0,0,0,0,0,0,0,NA,0,0,0,0,0,0,0,0,"Matches","https://fbref.com/en/comps/9/2020-2021/defense/2020-2021-Premier-League-Stats"
"William Smallbone","Southampton",2021,"ie IRL","MF",20,2000,1.9,6,3,2,4,0,1,3,33.3,2,5,0,5,2,8,1,0,"Matches","https://fbref.com/en/comps/9/2020-2021/defense/2020-2021-Premier-League-Stats"
"Emile Smith Rowe","Arsenal",2021,"eng ENG","MF,FW",20,2000,16,14,7,5,5,4,6,17,35.3,11,15,1,14,10,24,12,0,"Matches","https://fbref.com/en/comps/9/2020-2021/defense/2020-2021-Premier-League-Stats"
"Robert Snodgrass","West Brom",2021,"sct SCO","MF,FW",32,1987,5.8,17,12,12,4,1,10,16,62.5,6,11,2,9,1,18,12,0,"Matches","https://fbref.com/en/comps/9/2020-2021/defense/2020-2021-Premier-League-Stats"
"Robert Snodgrass","West Ham",2021,"sct SCO","FW,MF",32,1987,0.1,0,0,0,0,0,0,0,NA,0,0,0,0,0,0,0,0,"Matches","https://fbref.com/en/comps/9/2020-2021/defense/2020-2021-Premier-League-Stats"
"Cédric Soares","Arsenal",2021,"pt POR","DF",28,1991,8.3,12,8,6,4,2,6,21,28.6,15,6,1,5,8,20,16,1,"Matches","https://fbref.com/en/comps/9/2020-2021/defense/2020-2021-Premier-League-Stats"
"Tomá Soucek","West Ham",2021,"cz CZE","MF",25,1995,38,78,41,37,36,5,28,77,36.4,49,43,18,25,62,140,107,0,"Matches","https://fbref.com/en/comps/9/2020-2021/defense/2020-2021-Premier-League-Stats"
"Çaglar Söyüncü","Leicester City",2021,"tr TUR","DF",24,1996,20.2,27,17,13,14,0,17,30,56.7,13,12,9,3,28,55,80,1,"Matches","https://fbref.com/en/comps/9/2020-2021/defense/2020-2021-Premier-League-Stats"
"Zack Steffen","Manchester City",2021,"us USA","GK",25,1995,1,0,0,0,0,0,0,0,NA,0,0,0,0,0,0,0,0,"Matches","https://fbref.com/en/comps/9/2020-2021/defense/2020-2021-Premier-League-Stats"
"Dale Stephens","Burnley",2021,"eng ENG","MF",31,1989,2.9,11,6,2,7,2,3,6,50,3,3,0,3,8,19,2,0,"Matches","https://fbref.com/en/comps/9/2020-2021/defense/2020-2021-Premier-League-Stats"
"Jack Stephens","Southampton",2021,"eng ENG","DF",26,1994,17.1,34,19,19,15,0,17,38,44.7,21,25,14,11,28,62,64,2,"Matches","https://fbref.com/en/comps/9/2020-2021/defense/2020-2021-Premier-League-Stats"
"Raheem Sterling","Manchester City",2021,"eng ENG","FW",25,1994,28.2,21,10,5,12,4,5,12,41.7,7,15,0,15,15,36,4,0,"Matches","https://fbref.com/en/comps/9/2020-2021/defense/2020-2021-Premier-League-Stats"
"Enda Stevens","Sheffield Utd",2021,"ie IRL","DF",30,1990,30,59,26,32,19,8,33,58,56.9,25,41,12,29,22,81,81,1,"Matches","https://fbref.com/en/comps/9/2020-2021/defense/2020-2021-Premier-League-Stats"
"John Stones","Manchester City",2021,"eng ENG","DF",26,1994,21.5,21,10,13,5,3,9,14,64.3,5,23,15,8,18,39,56,1,"Matches","https://fbref.com/en/comps/9/2020-2021/defense/2020-2021-Premier-League-Stats"
"Pascal Struijk","Leeds United",2021,"nl NED","DF,MF",20,1999,23.1,49,30,28,19,2,17,28,60.7,11,35,21,14,47,96,92,0,"Matches","https://fbref.com/en/comps/9/2020-2021/defense/2020-2021-Premier-League-Stats"
"Japhet Tanganga","Tottenham",2021,"eng ENG","DF",21,1999,5.4,5,4,3,2,0,1,3,33.3,2,6,5,1,3,8,15,0,"Matches","https://fbref.com/en/comps/9/2020-2021/defense/2020-2021-Premier-League-Stats"
"Matt Targett","Aston Villa",2021,"eng ENG","DF",24,1995,37.8,83,39,52,20,11,56,88,63.6,32,40,14,26,55,138,102,1,"Matches","https://fbref.com/en/comps/9/2020-2021/defense/2020-2021-Premier-League-Stats"
"James Tarkowski","Burnley",2021,"eng ENG","DF",27,1992,36,66,39,52,11,3,25,49,51,24,54,42,12,44,110,163,1,"Matches","https://fbref.com/en/comps/9/2020-2021/defense/2020-2021-Premier-League-Stats"
"Percy Tau","Brighton",2021,"za RSA","FW",26,1994,1.1,1,1,1,0,0,0,2,0,2,1,0,1,0,1,1,0,"Matches","https://fbref.com/en/comps/9/2020-2021/defense/2020-2021-Premier-League-Stats"
"Sidnei Tavares","Leicester City",2021,"pt POR","MF",18,2001,0.9,1,1,0,1,0,0,0,NA,0,1,1,0,0,1,0,0,"Matches","https://fbref.com/en/comps/9/2020-2021/defense/2020-2021-Premier-League-Stats"
"Charlie Taylor","Burnley",2021,"eng ENG","DF",26,1993,27,48,28,30,15,3,25,46,54.3,21,36,19,17,29,77,87,2,"Matches","https://fbref.com/en/comps/9/2020-2021/defense/2020-2021-Premier-League-Stats"
"Neil Taylor","Aston Villa",2021,"wls WAL","DF",31,1989,0.2,1,1,1,0,0,0,0,NA,0,1,0,1,0,1,0,0,"Matches","https://fbref.com/en/comps/9/2020-2021/defense/2020-2021-Premier-League-Stats"
"Allan Tchaptchet","Southampton",2021,"fr FRA","DF",18,2001,0.1,0,0,0,0,0,0,0,NA,0,0,0,0,0,0,0,0,"Matches","https://fbref.com/en/comps/9/2020-2021/defense/2020-2021-Premier-League-Stats"
"Nathan Tella","Southampton",2021,"eng ENG","FW,MF",21,1999,8.3,8,5,1,4,3,6,15,40,9,13,0,13,3,11,2,0,"Matches","https://fbref.com/en/comps/9/2020-2021/defense/2020-2021-Premier-League-Stats"
"Alex Telles","Manchester Utd",2021,"br BRA","DF",27,1992,7.7,14,7,10,3,1,8,17,47.1,9,7,2,5,16,30,20,0,"Matches","https://fbref.com/en/comps/9/2020-2021/defense/2020-2021-Premier-League-Stats"
"Kenny Tete","Fulham",2021,"nl NED","DF,MF",24,1995,16.5,48,30,27,16,5,10,18,55.6,8,14,5,9,27,75,49,0,"Matches","https://fbref.com/en/comps/9/2020-2021/defense/2020-2021-Premier-League-Stats"
"William Thomas Fish","Manchester Utd",2021,"eng ENG","FW",17,2003,0,0,0,0,0,0,0,0,NA,0,0,0,0,0,0,0,0,"Matches","https://fbref.com/en/comps/9/2020-2021/defense/2020-2021-Premier-League-Stats"
"Luke Thomas","Leicester City",2021,"eng ENG","DF",19,2001,10.8,23,14,11,5,7,14,21,66.7,7,15,2,13,17,40,21,0,"Matches","https://fbref.com/en/comps/9/2020-2021/defense/2020-2021-Premier-League-Stats"
"Youri Tielemans","Leicester City",2021,"be BEL","MF",23,1997,37.3,86,45,32,38,16,45,108,41.7,63,35,8,27,46,132,20,1,"Matches","https://fbref.com/en/comps/9/2020-2021/defense/2020-2021-Premier-League-Stats"
"Kieran Tierney","Arsenal",2021,"sct SCO","DF",23,1997,25.5,27,15,5,14,8,11,31,35.5,20,31,10,21,16,43,63,0,"Matches","https://fbref.com/en/comps/9/2020-2021/defense/2020-2021-Premier-League-Stats"
"James Tomkins","Crystal Palace",2021,"eng ENG","DF",31,1989,6.1,4,2,4,0,0,3,4,75,1,4,3,1,4,8,45,0,"Matches","https://fbref.com/en/comps/9/2020-2021/defense/2020-2021-Premier-League-Stats"
"Fikayo Tomori","Chelsea",2021,"eng ENG","DF",22,1997,0.5,2,1,2,0,0,0,0,NA,0,1,1,0,2,4,8,0,"Matches","https://fbref.com/en/comps/9/2020-2021/defense/2020-2021-Premier-League-Stats"
"Ferrán Torres","Manchester City",2021,"es ESP","FW,MF",20,2000,14.5,12,5,4,6,2,5,16,31.3,11,16,0,16,3,15,8,0,"Matches","https://fbref.com/en/comps/9/2020-2021/defense/2020-2021-Premier-League-Stats"
"Cenk Tosun","Everton",2021,"tr TUR","FW",29,1991,0.5,0,0,0,0,0,0,1,0,1,0,0,0,0,0,0,0,"Matches","https://fbref.com/en/comps/9/2020-2021/defense/2020-2021-Premier-League-Stats"
"Andros Townsend","Crystal Palace",2021,"eng ENG","MF,FW",29,1991,25.1,78,41,45,20,13,30,79,38,49,48,2,46,41,119,19,0,"Matches","https://fbref.com/en/comps/9/2020-2021/defense/2020-2021-Premier-League-Stats"
"Conor Townsend","West Brom",2021,"eng ENG","DF",27,1993,24.8,44,28,32,9,3,30,49,61.2,19,38,15,23,36,80,55,2,"Matches","https://fbref.com/en/comps/9/2020-2021/defense/2020-2021-Premier-League-Stats"
"Adama Traoré","Wolves",2021,"es ESP","FW,MF",24,1996,29.4,28,16,11,13,4,13,21,61.9,8,23,1,22,7,35,12,1,"Matches","https://fbref.com/en/comps/9/2020-2021/defense/2020-2021-Premier-League-Stats"
"Bertrand Traoré","Aston Villa",2021,"bf BFA","FW",24,1995,25.7,26,10,8,10,8,10,34,29.4,24,23,1,22,15,41,14,1,"Matches","https://fbref.com/en/comps/9/2020-2021/defense/2020-2021-Premier-League-Stats"
"Trézéguet","Aston Villa",2021,"eg EGY","FW",25,1994,13,33,18,14,15,4,13,45,28.9,32,13,1,12,19,52,17,0,"Matches","https://fbref.com/en/comps/9/2020-2021/defense/2020-2021-Premier-League-Stats"
"Leandro Trossard","Brighton",2021,"be BEL","MF,FW",25,1994,29,33,14,11,16,6,10,36,27.8,26,34,2,32,26,59,7,1,"Matches","https://fbref.com/en/comps/9/2020-2021/defense/2020-2021-Premier-League-Stats"
"Kostas Tsimikas","Liverpool",2021,"gr GRE","DF,FW",24,1996,0.1,0,0,0,0,0,0,0,NA,0,0,0,0,0,0,0,0,"Matches","https://fbref.com/en/comps/9/2020-2021/defense/2020-2021-Premier-League-Stats"
"Axel Tuanzebe","Manchester Utd",2021,"eng ENG","DF",22,1997,4.5,13,7,5,7,1,8,9,88.9,1,7,5,2,3,16,18,0,"Matches","https://fbref.com/en/comps/9/2020-2021/defense/2020-2021-Premier-League-Stats"
"Cengiz Ünder","Leicester City",2021,"tr TUR","FW,MF",23,1997,3.1,4,1,0,3,1,3,5,60,2,3,0,3,2,6,0,0,"Matches","https://fbref.com/en/comps/9/2020-2021/defense/2020-2021-Premier-League-Stats"
"Yan Valery","Southampton",2021,"tn TUN","DF,MF",21,1999,1.1,5,3,2,3,0,1,5,20,4,2,0,2,2,7,5,0,"Matches","https://fbref.com/en/comps/9/2020-2021/defense/2020-2021-Premier-League-Stats"
"Virgil van Dijk","Liverpool",2021,"nl NED","DF",29,1991,4.1,3,2,1,2,0,0,0,NA,0,1,1,0,5,8,8,1,"Matches","https://fbref.com/en/comps/9/2020-2021/defense/2020-2021-Premier-League-Stats"
"Jamie Vardy","Leicester City",2021,"eng ENG","FW",33,1987,31.6,18,12,1,8,9,2,15,13.3,13,14,5,9,4,22,32,0,"Matches","https://fbref.com/en/comps/9/2020-2021/defense/2020-2021-Premier-League-Stats"
"Joël Veltman","Brighton",2021,"nl NED","DF",28,1992,25.3,67,33,34,25,8,29,57,50.9,28,24,5,19,33,100,64,0,"Matches","https://fbref.com/en/comps/9/2020-2021/defense/2020-2021-Premier-League-Stats"
"Jannik Vestergaard","Southampton",2021,"dk DEN","DF",27,1992,28.6,50,31,31,15,4,35,52,67.3,17,29,16,13,42,92,122,0,"Matches","https://fbref.com/en/comps/9/2020-2021/defense/2020-2021-Premier-League-Stats"
"Rúben Vinagre","Wolves",2021,"pt POR","MF,DF",21,1999,1.9,7,5,5,2,0,3,4,75,1,3,0,3,2,9,4,0,"Matches","https://fbref.com/en/comps/9/2020-2021/defense/2020-2021-Premier-League-Stats"
"Carlos Vinícius","Tottenham",2021,"br BRA","FW",25,1995,3.4,3,1,2,1,0,1,1,100,0,0,0,0,2,5,5,0,"Matches","https://fbref.com/en/comps/9/2020-2021/defense/2020-2021-Premier-League-Stats"
"João Virgínia","Everton",2021,"pt POR","GK",20,1999,0.5,0,0,0,0,0,0,0,NA,0,0,0,0,0,0,0,0,"Matches","https://fbref.com/en/comps/9/2020-2021/defense/2020-2021-Premier-League-Stats"
"Vitinha","Wolves",2021,"pt POR","MF",20,2000,5.8,7,3,2,5,0,3,8,37.5,5,3,0,3,3,10,1,0,"Matches","https://fbref.com/en/comps/9/2020-2021/defense/2020-2021-Premier-League-Stats"
"Jake Vokins","Southampton",2021,"eng ENG","DF",20,2000,0.7,0,0,0,0,0,0,1,0,1,0,0,0,0,0,0,0,"Matches","https://fbref.com/en/comps/9/2020-2021/defense/2020-2021-Premier-League-Stats"
"Matej Vydra","Burnley",2021,"cz CZE","FW",28,1992,15.2,9,5,2,4,3,1,8,12.5,7,8,1,7,6,15,5,0,"Matches","https://fbref.com/en/comps/9/2020-2021/defense/2020-2021-Premier-League-Stats"
"Theo Walcott","Southampton",2021,"eng ENG","MF,FW",31,1989,18,23,11,8,9,6,11,32,34.4,21,16,0,16,14,37,5,0,"Matches","https://fbref.com/en/comps/9/2020-2021/defense/2020-2021-Premier-League-Stats"
"Theo Walcott","Everton",2021,"eng ENG","FW",31,1989,0.1,0,0,0,0,0,0,0,NA,0,0,0,0,0,0,0,0,"Matches","https://fbref.com/en/comps/9/2020-2021/defense/2020-2021-Premier-League-Stats"
"Kyle Walker","Manchester City",2021,"eng ENG","DF",30,1990,21.6,29,19,15,12,2,16,24,66.7,8,19,7,12,14,43,28,0,"Matches","https://fbref.com/en/comps/9/2020-2021/defense/2020-2021-Premier-League-Stats"
"Kyle Walker-Peters","Southampton",2021,"eng ENG","DF",23,1997,29.4,83,53,56,25,2,34,57,59.6,23,41,10,31,38,121,66,2,"Matches","https://fbref.com/en/comps/9/2020-2021/defense/2020-2021-Premier-League-Stats"
"Aaron Wan-Bissaka","Manchester Utd",2021,"eng ENG","DF",22,1997,34,88,54,53,29,6,32,45,71.1,13,65,17,48,62,150,84,2,"Matches","https://fbref.com/en/comps/9/2020-2021/defense/2020-2021-Premier-League-Stats"
"Joel Ward","Crystal Palace",2021,"eng ENG","DF",30,1989,25.1,43,25,29,14,0,24,42,57.1,18,27,8,19,41,84,87,2,"Matches","https://fbref.com/en/comps/9/2020-2021/defense/2020-2021-Premier-League-Stats"
"James Ward-Prowse","Southampton",2021,"eng ENG","MF",25,1994,38,75,49,30,41,4,29,70,41.4,41,36,4,32,42,117,60,0,"Matches","https://fbref.com/en/comps/9/2020-2021/defense/2020-2021-Premier-League-Stats"
"Ollie Watkins","Aston Villa",2021,"eng ENG","FW",24,1995,37,29,17,5,16,8,10,33,30.3,23,21,2,19,7,36,24,0,"Matches","https://fbref.com/en/comps/9/2020-2021/defense/2020-2021-Premier-League-Stats"
"Caleb Watts","Southampton",2021,"au AUS","MF",18,2002,0.4,2,1,2,0,0,1,2,50,1,0,0,0,0,2,0,0,"Matches","https://fbref.com/en/comps/9/2020-2021/defense/2020-2021-Premier-League-Stats"
"Adam Webster","Brighton",2021,"eng ENG","DF",25,1995,28.8,29,16,15,10,4,12,25,48,13,29,16,13,47,76,92,3,"Matches","https://fbref.com/en/comps/9/2020-2021/defense/2020-2021-Premier-League-Stats"
"Danny Welbeck","Brighton",2021,"eng ENG","FW",29,1990,17.2,12,6,2,6,4,7,19,36.8,12,17,0,17,7,19,13,0,"Matches","https://fbref.com/en/comps/9/2020-2021/defense/2020-2021-Premier-League-Stats"
"Timo Werner","Chelsea",2021,"de GER","FW,MF",24,1996,28.9,20,9,6,11,3,7,43,16.3,36,23,1,22,8,28,8,0,"Matches","https://fbref.com/en/comps/9/2020-2021/defense/2020-2021-Premier-League-Stats"
"Ashley Westwood","Burnley",2021,"eng ENG","MF",30,1990,37.9,23,15,6,12,5,10,42,23.8,32,26,9,17,44,67,33,0,"Matches","https://fbref.com/en/comps/9/2020-2021/defense/2020-2021-Premier-League-Stats"
"Ben White","Brighton",2021,"eng ENG","DF,MF",22,1997,35.5,49,26,21,24,4,24,57,42.1,33,46,22,24,62,111,56,0,"Matches","https://fbref.com/en/comps/9/2020-2021/defense/2020-2021-Premier-League-Stats"
"Georginio Wijnaldum","Liverpool",2021,"nl NED","MF",29,1990,32.7,23,7,6,14,3,7,31,22.6,24,18,3,15,26,49,18,1,"Matches","https://fbref.com/en/comps/9/2020-2021/defense/2020-2021-Premier-League-Stats"
"Brandon Williams","Manchester Utd",2021,"eng ENG","DF",19,2000,2.1,0,0,0,0,0,0,1,0,1,1,0,1,1,1,7,0,"Matches","https://fbref.com/en/comps/9/2020-2021/defense/2020-2021-Premier-League-Stats"
"Neco Williams","Liverpool",2021,"wls WAL","DF",19,2001,2.8,6,5,4,2,0,5,9,55.6,4,3,1,2,6,12,6,0,"Matches","https://fbref.com/en/comps/9/2020-2021/defense/2020-2021-Premier-League-Stats"
"Rhys Williams","Liverpool",2021,"eng ENG","DF",19,2001,7.3,6,4,3,3,0,3,3,100,0,4,3,1,6,12,27,1,"Matches","https://fbref.com/en/comps/9/2020-2021/defense/2020-2021-Premier-League-Stats"
"Willian","Arsenal",2021,"br BRA","FW",31,1988,15.6,13,7,6,6,1,6,16,37.5,10,13,0,13,8,21,8,0,"Matches","https://fbref.com/en/comps/9/2020-2021/defense/2020-2021-Premier-League-Stats"
"Joe Willock","Arsenal",2021,"eng ENG","MF",20,1999,2.6,6,3,1,4,1,3,7,42.9,4,6,1,5,3,9,0,0,"Matches","https://fbref.com/en/comps/9/2020-2021/defense/2020-2021-Premier-League-Stats"
"Joe Willock","Newcastle Utd",2021,"eng ENG","MF",20,1999,10.9,26,13,16,7,3,9,42,21.4,33,21,3,18,17,43,15,1,"Matches","https://fbref.com/en/comps/9/2020-2021/defense/2020-2021-Premier-League-Stats"
"Callum Wilson","Newcastle Utd",2021,"eng ENG","FW",28,1992,23.2,12,5,1,6,5,2,12,16.7,10,10,3,7,7,19,14,0,"Matches","https://fbref.com/en/comps/9/2020-2021/defense/2020-2021-Premier-League-Stats"
"Harry Winks","Tottenham",2021,"eng ENG","MF",24,1996,9.6,16,9,11,5,0,5,20,25,15,16,4,12,11,27,12,1,"Matches","https://fbref.com/en/comps/9/2020-2021/defense/2020-2021-Premier-League-Stats"
"Chris Wood","Burnley",2021,"nz NZL","FW",28,1991,30.5,12,7,2,4,6,5,18,27.8,13,14,3,11,1,13,21,0,"Matches","https://fbref.com/en/comps/9/2020-2021/defense/2020-2021-Premier-League-Stats"
"Granit Xhaka","Arsenal",2021,"ch SUI","MF,DF",27,1992,28,50,26,18,17,15,30,58,51.7,28,23,7,16,24,74,38,3,"Matches","https://fbref.com/en/comps/9/2020-2021/defense/2020-2021-Premier-League-Stats"
"Andriy Yarmolenko","West Ham",2021,"ua UKR","FW,MF",30,1989,4.2,5,4,2,2,1,2,8,25,6,1,0,1,1,6,2,0,"Matches","https://fbref.com/en/comps/9/2020-2021/defense/2020-2021-Premier-League-Stats"
"DeAndre Yedlin","Newcastle Utd",2021,"us USA","DF",27,1993,4.8,9,4,8,1,0,4,10,40,6,5,1,4,7,16,17,0,"Matches","https://fbref.com/en/comps/9/2020-2021/defense/2020-2021-Premier-League-Stats"
"Okay Yokuslu","West Brom",2021,"tr TUR","MF",26,1994,14.6,38,25,21,13,4,17,35,48.6,18,15,3,12,35,73,33,1,"Matches","https://fbref.com/en/comps/9/2020-2021/defense/2020-2021-Premier-League-Stats"
"Wilfried Zaha","Crystal Palace",2021,"ci CIV","FW",27,1992,29,26,18,8,15,3,11,30,36.7,19,21,0,21,9,35,4,0,"Matches","https://fbref.com/en/comps/9/2020-2021/defense/2020-2021-Premier-League-Stats"
"Andre-Frank Zambo Anguissa","Fulham",2021,"cm CMR","MF",24,1995,28.7,78,37,27,38,13,27,68,39.7,41,35,6,29,56,134,17,2,"Matches","https://fbref.com/en/comps/9/2020-2021/defense/2020-2021-Premier-League-Stats"
"Andi Zeqiri","Brighton",2021,"ch SUI","FW,DF",21,1999,1.9,3,2,0,2,1,1,2,50,1,1,0,1,0,3,2,0,"Matches","https://fbref.com/en/comps/9/2020-2021/defense/2020-2021-Premier-League-Stats"
"Oleksandr Zinchenko","Manchester City",2021,"ua UKR","DF",23,1996,16.4,25,15,12,9,4,14,24,58.3,10,17,4,13,23,48,28,0,"Matches","https://fbref.com/en/comps/9/2020-2021/defense/2020-2021-Premier-League-Stats"
"Hakim Ziyech","Chelsea",2021,"ma MAR","MF,FW",27,1993,13,14,10,5,7,2,5,19,26.3,14,9,1,8,10,24,2,0,"Matches","https://fbref.com/en/comps/9/2020-2021/defense/2020-2021-Premier-League-Stats"
"Kurt Zouma","Chelsea",2021,"fr FRA","DF",25,1994,22.5,16,10,8,6,2,4,8,50,4,13,9,4,28,44,93,0,"Matches","https://fbref.com/en/comps/9/2020-2021/defense/2020-2021-Premier-League-Stats"
"Martin Ødegaard","Arsenal",2021,"no NOR","MF",21,1998,9.6,9,3,2,6,1,4,14,28.6,10,2,0,2,2,11,5,0,"Matches","https://fbref.com/en/comps/9/2020-2021/defense/2020-2021-Premier-League-Stats"
