"Player","Squad","Season","Nation","Pos","Age","Born","Mins_Per_90","Tkl_Tackles","TklW_Tackles","Def 3rd_Tackles","Mid 3rd_Tackles","Att 3rd_Tackles","Tkl_Challenges","Att_Challenges","Tkl_percent_Challenges","Lost_Challenges","Blocks_Blocks","Sh_Blocks","Pass_Blocks","Int","Tkl+Int","Clr","Err","Matches","url"
"Max Aarons","Norwich City",2022,"eng ENG","DF",21,2000,32,64,44,49,15,0,37,55,67.3,18,39,19,20,28,92,96,1,"Matches","https://fbref.com/en/comps/9/2021-2022/defense/2021-2022-Premier-League-Stats"
"Che Adams","Southampton",2022,"sct SCO","FW",25,1996,22.7,13,6,5,5,3,2,16,12.5,14,18,2,16,8,21,18,0,"Matches","https://fbref.com/en/comps/9/2021-2022/defense/2021-2022-Premier-League-Stats"
"Rayan Aït Nouri","Wolves",2022,"dz ALG","DF,MF",20,2001,20.3,64,36,46,15,3,22,44,50,22,24,2,22,22,86,39,1,"Matches","https://fbref.com/en/comps/9/2021-2022/defense/2021-2022-Premier-League-Stats"
"Kristoffer Ajer","Brentford",2022,"no NOR","DF",23,1998,22.2,29,18,21,6,2,13,21,61.9,8,19,11,8,26,55,74,0,"Matches","https://fbref.com/en/comps/9/2021-2022/defense/2021-2022-Premier-League-Stats"
"Nathan Aké","Manchester City",2022,"nl NED","DF",26,1995,10.3,16,9,7,8,1,6,8,75,2,7,5,2,8,24,23,0,"Matches","https://fbref.com/en/comps/9/2021-2022/defense/2021-2022-Premier-League-Stats"
"Marc Albrighton","Leicester City",2022,"eng ENG","FW,DF",31,1989,12.6,31,19,16,9,6,10,47,21.3,37,15,3,12,14,45,20,0,"Matches","https://fbref.com/en/comps/9/2021-2022/defense/2021-2022-Premier-League-Stats"
"Thiago Alcántara","Liverpool",2022,"es ESP","MF",30,1991,17,48,29,14,24,10,10,42,23.8,32,22,2,20,26,74,13,2,"Matches","https://fbref.com/en/comps/9/2021-2022/defense/2021-2022-Premier-League-Stats"
"Trent Alexander-Arnold","Liverpool",2022,"eng ENG","DF",22,1998,31.7,40,23,19,13,8,27,60,45,33,22,4,18,43,83,40,0,"Matches","https://fbref.com/en/comps/9/2021-2022/defense/2021-2022-Premier-League-Stats"
"Alisson","Liverpool",2022,"br BRA","GK",28,1992,36,3,1,3,0,0,3,5,60,2,1,0,1,0,3,28,1,"Matches","https://fbref.com/en/comps/9/2021-2022/defense/2021-2022-Premier-League-Stats"
"Allan","Everton",2022,"br BRA","MF",30,1991,24.3,74,44,28,39,7,34,105,32.4,71,40,9,31,23,97,39,1,"Matches","https://fbref.com/en/comps/9/2021-2022/defense/2021-2022-Premier-League-Stats"
"Dele Alli","Tottenham",2022,"eng ENG","MF",25,1996,7.3,14,8,10,3,1,5,17,29.4,12,22,5,17,6,20,16,0,"Matches","https://fbref.com/en/comps/9/2021-2022/defense/2021-2022-Premier-League-Stats"
"Dele Alli","Everton",2022,"eng ENG","MF,FW",25,1996,3.8,7,2,3,4,0,0,4,0,4,7,2,5,6,13,10,0,"Matches","https://fbref.com/en/comps/9/2021-2022/defense/2021-2022-Premier-League-Stats"
"Miguel Almirón","Newcastle Utd",2022,"py PAR","MF,FW",27,1994,19.1,47,29,23,17,7,11,44,25,33,14,1,13,20,67,13,0,"Matches","https://fbref.com/en/comps/9/2021-2022/defense/2021-2022-Premier-League-Stats"
"Marcos Alonso","Chelsea",2022,"es ESP","DF",30,1990,24.1,41,29,20,12,9,17,36,47.2,19,29,5,24,43,84,53,0,"Matches","https://fbref.com/en/comps/9/2021-2022/defense/2021-2022-Premier-League-Stats"
"Steven Alzate","Brighton",2022,"co COL","MF",22,1998,4.5,10,4,4,5,1,4,7,57.1,3,2,1,1,10,20,10,0,"Matches","https://fbref.com/en/comps/9/2021-2022/defense/2021-2022-Premier-League-Stats"
"Daniel Amartey","Leicester City",2022,"gh GHA","DF",26,1994,23.6,26,13,19,7,0,19,29,65.5,10,30,22,8,21,47,93,4,"Matches","https://fbref.com/en/comps/9/2021-2022/defense/2021-2022-Premier-League-Stats"
"Joachim Andersen","Crystal Palace",2022,"dk DEN","DF",25,1996,32.4,30,23,21,9,0,16,27,59.3,11,29,19,10,37,67,125,3,"Matches","https://fbref.com/en/comps/9/2021-2022/defense/2021-2022-Premier-League-Stats"
"Michail Antonio","West Ham",2022,"jm JAM","FW",31,1990,33,23,17,5,9,9,7,18,38.9,11,19,1,18,3,26,13,0,"Matches","https://fbref.com/en/comps/9/2021-2022/defense/2021-2022-Premier-League-Stats"
"Cameron Archer","Aston Villa",2022,"eng ENG","FW,MF",20,2001,0.3,0,0,0,0,0,0,0,NA,0,0,0,0,0,0,0,0,"Matches","https://fbref.com/en/comps/9/2021-2022/defense/2021-2022-Premier-League-Stats"
"Alphonse Areola","West Ham",2022,"fr FRA","GK",28,1993,1,0,0,0,0,0,0,0,NA,0,0,0,0,0,0,1,0,"Matches","https://fbref.com/en/comps/9/2021-2022/defense/2021-2022-Premier-League-Stats"
"Adam Armstrong","Southampton",2022,"eng ENG","FW",24,1997,15.7,10,4,2,2,6,0,6,0,6,13,1,12,3,13,6,0,"Matches","https://fbref.com/en/comps/9/2021-2022/defense/2021-2022-Premier-League-Stats"
"Stuart Armstrong","Southampton",2022,"sct SCO","MF",29,1992,16.4,27,19,15,6,6,9,23,39.1,14,10,1,9,8,35,15,0,"Matches","https://fbref.com/en/comps/9/2021-2022/defense/2021-2022-Premier-League-Stats"
"Kepa Arrizabalaga","Chelsea",2022,"es ESP","GK",26,1994,4,0,0,0,0,0,0,0,NA,0,0,0,0,0,0,4,0,"Matches","https://fbref.com/en/comps/9/2021-2022/defense/2021-2022-Premier-League-Stats"
"Harrison Ashby","West Ham",2022,"sct SCO","DF",19,2001,0.1,0,0,0,0,0,0,0,NA,0,1,0,1,1,1,1,0,"Matches","https://fbref.com/en/comps/9/2021-2022/defense/2021-2022-Premier-League-Stats"
"Pierre-Emerick Aubameyang","Arsenal",2022,"ga GAB","FW",32,1989,11.5,11,5,6,4,1,3,10,30,7,12,1,11,0,11,4,0,"Matches","https://fbref.com/en/comps/9/2021-2022/defense/2021-2022-Premier-League-Stats"
"Jordan Ayew","Crystal Palace",2022,"gh GHA","FW",29,1991,22.4,47,30,20,20,7,17,31,54.8,14,33,3,30,15,62,15,0,"Matches","https://fbref.com/en/comps/9/2021-2022/defense/2021-2022-Premier-League-Stats"
"Luke Ayling","Leeds United",2022,"eng ENG","DF",29,1991,25.2,74,42,46,23,5,51,97,52.6,46,46,25,21,28,102,52,1,"Matches","https://fbref.com/en/comps/9/2021-2022/defense/2021-2022-Premier-League-Stats"
"César Azpilicueta","Chelsea",2022,"es ESP","DF",31,1989,23,51,28,18,27,6,16,35,45.7,19,32,9,23,23,74,65,1,"Matches","https://fbref.com/en/comps/9/2021-2022/defense/2021-2022-Premier-League-Stats"
"Daniel Bachmann","Watford",2022,"at AUT","GK",27,1994,12,0,0,0,0,0,0,0,NA,0,0,0,0,1,1,5,0,"Matches","https://fbref.com/en/comps/9/2021-2022/defense/2021-2022-Premier-League-Stats"
"Leon Bailey","Aston Villa",2022,"jm JAM","FW,MF",23,1997,8.5,17,11,6,8,3,6,13,46.2,7,10,1,9,1,18,2,0,"Matches","https://fbref.com/en/comps/9/2021-2022/defense/2021-2022-Premier-League-Stats"
"Eric Bailly","Manchester Utd",2022,"ci CIV","DF",27,1994,2.4,5,4,4,0,1,3,4,75,1,4,2,2,3,8,11,0,"Matches","https://fbref.com/en/comps/9/2021-2022/defense/2021-2022-Premier-League-Stats"
"Folarin Balogun","Arsenal",2022,"us USA","FW",20,2001,0.8,1,1,0,0,1,0,0,NA,0,1,0,1,0,1,1,0,"Matches","https://fbref.com/en/comps/9/2021-2022/defense/2021-2022-Premier-League-Stats"
"Patrick Bamford","Leeds United",2022,"eng ENG","FW",27,1993,6.2,1,0,0,1,0,0,3,0,3,8,2,6,2,3,8,0,"Matches","https://fbref.com/en/comps/9/2021-2022/defense/2021-2022-Premier-League-Stats"
"Shandon Baptiste","Brentford",2022,"gd GRN","MF",23,1998,10.1,14,4,9,4,1,6,15,40,9,10,0,10,11,25,12,0,"Matches","https://fbref.com/en/comps/9/2021-2022/defense/2021-2022-Premier-League-Stats"
"Ross Barkley","Chelsea",2022,"eng ENG","MF,FW",27,1993,2,0,0,0,0,0,0,1,0,1,1,0,1,1,1,0,0,"Matches","https://fbref.com/en/comps/9/2021-2022/defense/2021-2022-Premier-League-Stats"
"Ashley Barnes","Burnley",2022,"eng ENG","FW",31,1989,9,11,2,2,7,2,2,9,22.2,7,8,1,7,2,13,5,0,"Matches","https://fbref.com/en/comps/9/2021-2022/defense/2021-2022-Premier-League-Stats"
"Harvey Barnes","Leicester City",2022,"eng ENG","FW,MF",23,1997,23.3,31,16,9,11,11,7,23,30.4,16,24,1,23,5,36,7,0,"Matches","https://fbref.com/en/comps/9/2021-2022/defense/2021-2022-Premier-League-Stats"
"Lewis Bate","Leeds United",2022,"eng ENG","MF",18,2002,1.6,1,0,0,0,1,0,8,0,8,1,0,1,1,2,1,0,"Matches","https://fbref.com/en/comps/9/2021-2022/defense/2021-2022-Premier-League-Stats"
"Mads Bech Sørensen","Brentford",2022,"dk DEN","DF",22,1999,9.3,8,7,6,2,0,6,7,85.7,1,9,6,3,6,14,25,0,"Matches","https://fbref.com/en/comps/9/2021-2022/defense/2021-2022-Premier-League-Stats"
"Jan Bednarek","Southampton",2022,"pl POL","DF",25,1996,29.2,32,15,18,13,1,19,33,57.6,14,48,27,21,72,104,141,0,"Matches","https://fbref.com/en/comps/9/2021-2022/defense/2021-2022-Premier-League-Stats"
"Donny van de Beek","Manchester Utd",2022,"nl NED","MF",24,1997,0.8,6,4,4,1,1,1,2,50,1,5,1,4,2,8,1,0,"Matches","https://fbref.com/en/comps/9/2021-2022/defense/2021-2022-Premier-League-Stats"
"Donny van de Beek","Everton",2022,"nl NED","MF",24,1997,5.4,15,7,8,6,1,6,13,46.2,7,6,2,4,6,21,4,0,"Matches","https://fbref.com/en/comps/9/2021-2022/defense/2021-2022-Premier-League-Stats"
"Asmir Begovic","Everton",2022,"ba BIH","GK",34,1987,3,0,0,0,0,0,0,0,NA,0,0,0,0,0,0,3,0,"Matches","https://fbref.com/en/comps/9/2021-2022/defense/2021-2022-Premier-League-Stats"
"Saïd Benrahma","West Ham",2022,"dz ALG","FW,MF",25,1995,24.1,28,17,16,9,3,15,38,39.5,23,17,1,16,9,37,8,0,"Matches","https://fbref.com/en/comps/9/2021-2022/defense/2021-2022-Premier-League-Stats"
"Rodrigo Bentancur","Tottenham",2022,"uy URU","MF",24,1997,15.1,36,18,14,14,8,16,32,50,16,24,9,15,20,56,35,0,"Matches","https://fbref.com/en/comps/9/2021-2022/defense/2021-2022-Premier-League-Stats"
"Christian Benteke","Crystal Palace",2022,"be BEL","FW",30,1990,12.7,3,2,1,2,0,2,6,33.3,4,7,3,4,2,5,33,0,"Matches","https://fbref.com/en/comps/9/2021-2022/defense/2021-2022-Premier-League-Stats"
"Jóhann Berg Guðmundsson","Burnley",2022,"is ISL","MF",30,1990,12.2,16,6,7,7,2,5,20,25,15,11,2,9,12,28,22,0,"Matches","https://fbref.com/en/comps/9/2021-2022/defense/2021-2022-Premier-League-Stats"
"Steven Bergwijn","Tottenham",2022,"nl NED","FW,MF",23,1997,6.3,3,2,2,1,0,1,10,10,9,3,0,3,1,4,8,0,"Matches","https://fbref.com/en/comps/9/2021-2022/defense/2021-2022-Premier-League-Stats"
"Ryan Bertrand","Leicester City",2022,"eng ENG","DF",31,1989,3.7,8,5,3,4,1,2,5,40,3,8,3,5,1,9,7,0,"Matches","https://fbref.com/en/comps/9/2021-2022/defense/2021-2022-Premier-League-Stats"
"Mads Bidstrup","Brentford",2022,"dk DEN","MF",20,2001,0.5,1,0,0,1,0,0,3,0,3,0,0,0,1,2,2,0,"Matches","https://fbref.com/en/comps/9/2021-2022/defense/2021-2022-Premier-League-Stats"
"Yves Bissouma","Brighton",2022,"ml MLI","MF",24,1996,23.5,76,49,35,37,4,21,37,56.8,16,33,3,30,50,126,49,0,"Matches","https://fbref.com/en/comps/9/2021-2022/defense/2021-2022-Premier-League-Stats"
"Willy Boly","Wolves",2022,"ci CIV","DF",30,1991,10,25,19,18,7,0,8,15,53.3,7,14,6,8,14,39,35,0,"Matches","https://fbref.com/en/comps/9/2021-2022/defense/2021-2022-Premier-League-Stats"
"Jarrod Bowen","West Ham",2022,"eng ENG","FW",24,1996,33.1,36,20,20,11,5,17,44,38.6,27,29,2,27,21,57,14,0,"Matches","https://fbref.com/en/comps/9/2021-2022/defense/2021-2022-Premier-League-Stats"
"Jarrad Branthwaite","Everton",2022,"eng ENG","DF",19,2002,4.3,4,1,3,1,0,3,8,37.5,5,3,2,1,1,5,20,0,"Matches","https://fbref.com/en/comps/9/2021-2022/defense/2021-2022-Premier-League-Stats"
"Armando Broja","Southampton",2022,"al ALB","FW",19,2001,21.9,12,5,2,7,3,2,9,22.2,7,17,1,16,3,15,11,0,"Matches","https://fbref.com/en/comps/9/2021-2022/defense/2021-2022-Premier-League-Stats"
"Josh Brownhill","Burnley",2022,"eng ENG","MF",25,1995,32.8,73,37,25,42,6,21,53,39.6,32,37,12,25,68,141,42,1,"Matches","https://fbref.com/en/comps/9/2021-2022/defense/2021-2022-Premier-League-Stats"
"Lewis Brunt","Leicester City",2022,"eng ENG","MF",20,2000,0.3,0,0,0,0,0,0,0,NA,0,1,0,1,0,0,0,0,"Matches","https://fbref.com/en/comps/9/2021-2022/defense/2021-2022-Premier-League-Stats"
"Bryan","Tottenham",2022,"es ESP","FW,MF",20,2001,1,3,0,1,0,2,1,2,50,1,2,0,2,0,3,0,0,"Matches","https://fbref.com/en/comps/9/2021-2022/defense/2021-2022-Premier-League-Stats"
"Emi Buendía","Aston Villa",2022,"ar ARG","MF,FW",24,1996,21.1,38,18,16,13,9,21,51,41.2,30,21,3,18,9,47,11,0,"Matches","https://fbref.com/en/comps/9/2021-2022/defense/2021-2022-Premier-League-Stats"
"Dan Burn","Newcastle Utd",2022,"eng ENG","DF",29,1992,16,16,11,11,4,1,7,11,63.6,4,22,14,8,20,36,101,0,"Matches","https://fbref.com/en/comps/9/2021-2022/defense/2021-2022-Premier-League-Stats"
"Dan Burn","Brighton",2022,"eng ENG","DF",29,1992,11.4,22,12,13,8,1,6,15,40,9,14,10,4,24,46,51,0,"Matches","https://fbref.com/en/comps/9/2021-2022/defense/2021-2022-Premier-League-Stats"
"Jack Butland","Crystal Palace",2022,"eng ENG","GK",28,1993,8.5,0,0,0,0,0,0,0,NA,0,0,0,0,0,0,1,0,"Matches","https://fbref.com/en/comps/9/2021-2022/defense/2021-2022-Premier-League-Stats"
"Sam Byram","Norwich City",2022,"eng ENG","DF",27,1993,11.4,24,15,17,6,1,19,27,70.4,8,21,11,10,22,46,48,0,"Matches","https://fbref.com/en/comps/9/2021-2022/defense/2021-2022-Premier-League-Stats"
"Willy Caballero","Southampton",2022,"ar ARG","GK",39,1981,2,0,0,0,0,0,0,0,NA,0,0,0,0,0,0,2,1,"Matches","https://fbref.com/en/comps/9/2021-2022/defense/2021-2022-Premier-League-Stats"
"Moisés Caicedo","Brighton",2022,"ec ECU","MF",19,2001,7.3,16,10,7,7,2,5,12,41.7,7,18,4,14,10,26,7,0,"Matches","https://fbref.com/en/comps/9/2021-2022/defense/2021-2022-Premier-League-Stats"
"Dominic Calvert-Lewin","Everton",2022,"eng ENG","FW",24,1997,14.3,11,8,1,6,4,3,8,37.5,5,5,2,3,3,14,12,0,"Matches","https://fbref.com/en/comps/9/2021-2022/defense/2021-2022-Premier-League-Stats"
"Chem Campbell","Wolves",2022,"wls WAL","MF",18,2002,0.1,1,1,0,1,0,0,0,NA,0,0,0,0,0,1,0,0,"Matches","https://fbref.com/en/comps/9/2021-2022/defense/2021-2022-Premier-League-Stats"
"João Cancelo","Manchester City",2022,"pt POR","DF",27,1994,35.9,83,54,33,35,15,46,91,50.5,45,25,3,22,59,142,45,1,"Matches","https://fbref.com/en/comps/9/2021-2022/defense/2021-2022-Premier-League-Stats"
"Sergi Canós","Brentford",2022,"es ESP","DF,FW",24,1997,23.1,56,25,32,15,9,33,60,55,27,32,3,29,22,78,38,0,"Matches","https://fbref.com/en/comps/9/2021-2022/defense/2021-2022-Premier-League-Stats"
"Todd Cantwell","Norwich City",2022,"eng ENG","FW,MF",23,1998,4.9,15,13,8,6,1,6,17,35.3,11,2,0,2,3,18,2,0,"Matches","https://fbref.com/en/comps/9/2021-2022/defense/2021-2022-Premier-League-Stats"
"Matty Cash","Aston Villa",2022,"pl POL","DF",23,1997,37.5,89,50,52,34,3,47,78,60.3,31,54,16,38,49,138,100,2,"Matches","https://fbref.com/en/comps/9/2021-2022/defense/2021-2022-Premier-League-Stats"
"Timothy Castagne","Leicester City",2022,"be BEL","DF",25,1995,23.6,67,31,38,22,7,27,43,62.8,16,28,9,19,29,96,54,1,"Matches","https://fbref.com/en/comps/9/2021-2022/defense/2021-2022-Premier-League-Stats"
"Jonny Castro","Wolves",2022,"es ESP","DF",27,1994,11.4,25,15,13,11,1,11,20,55,9,14,3,11,13,38,11,0,"Matches","https://fbref.com/en/comps/9/2021-2022/defense/2021-2022-Premier-League-Stats"
"Craig Cathcart","Watford",2022,"nir NIR","DF",32,1989,26.6,32,15,25,6,1,16,30,53.3,14,39,29,10,28,60,132,3,"Matches","https://fbref.com/en/comps/9/2021-2022/defense/2021-2022-Premier-League-Stats"
"Edinson Cavani","Manchester Utd",2022,"uy URU","FW",34,1987,8.5,4,1,0,3,1,2,8,25,6,6,0,6,2,6,8,0,"Matches","https://fbref.com/en/comps/9/2021-2022/defense/2021-2022-Premier-League-Stats"
"Kayky Chagas","Manchester City",2022,"br BRA","FW",18,2003,0.1,0,0,0,0,0,0,0,NA,0,0,0,0,0,0,0,0,"Matches","https://fbref.com/en/comps/9/2021-2022/defense/2021-2022-Premier-League-Stats"
"Trevoh Chalobah","Chelsea",2022,"eng ENG","DF",22,1999,16.1,40,27,22,18,0,24,31,77.4,7,16,6,10,19,59,43,2,"Matches","https://fbref.com/en/comps/9/2021-2022/defense/2021-2022-Premier-League-Stats"
"Calum Chambers","Arsenal",2022,"eng ENG","DF",26,1995,1.9,5,3,3,1,1,3,4,75,1,6,3,3,0,5,10,0,"Matches","https://fbref.com/en/comps/9/2021-2022/defense/2021-2022-Premier-League-Stats"
"Calum Chambers","Aston Villa",2022,"eng ENG","DF",26,1995,9.2,16,8,10,6,0,4,6,66.7,2,14,8,6,5,21,42,0,"Matches","https://fbref.com/en/comps/9/2021-2022/defense/2021-2022-Premier-League-Stats"
"Daniel Chesters","West Ham",2022,"eng ENG","MF",19,2002,0,0,0,0,0,0,0,0,NA,0,0,0,0,0,0,0,0,"Matches","https://fbref.com/en/comps/9/2021-2022/defense/2021-2022-Premier-League-Stats"
"Ben Chilwell","Chelsea",2022,"eng ENG","DF",24,1996,6,8,3,2,6,0,2,5,40,3,7,0,7,4,12,14,1,"Matches","https://fbref.com/en/comps/9/2021-2022/defense/2021-2022-Premier-League-Stats"
"Chiquinho","Wolves",2022,"pt POR","DF,FW",21,2000,2.3,9,6,4,5,0,4,5,80,1,5,0,5,2,11,1,0,"Matches","https://fbref.com/en/comps/9/2021-2022/defense/2021-2022-Premier-League-Stats"
"Hamza Choudhury","Leicester City",2022,"eng ENG","DF,MF",23,1997,3.2,9,3,4,4,1,3,5,60,2,0,0,0,12,21,10,0,"Matches","https://fbref.com/en/comps/9/2021-2022/defense/2021-2022-Premier-League-Stats"
"Andreas Christensen","Chelsea",2022,"dk DEN","DF",25,1996,16.6,14,8,9,4,1,4,7,57.1,3,14,6,8,29,43,57,1,"Matches","https://fbref.com/en/comps/9/2021-2022/defense/2021-2022-Premier-League-Stats"
"Carney Chukwuemeka","Aston Villa",2022,"eng ENG","MF,FW",17,2003,3.3,7,1,2,5,0,3,5,60,2,3,0,3,1,8,2,1,"Matches","https://fbref.com/en/comps/9/2021-2022/defense/2021-2022-Premier-League-Stats"
"Ciaran Clark","Newcastle Utd",2022,"ie IRL","DF",31,1989,11.3,13,10,4,7,2,9,14,64.3,5,14,11,3,13,26,43,1,"Matches","https://fbref.com/en/comps/9/2021-2022/defense/2021-2022-Premier-League-Stats"
"Tom Cleverley","Watford",2022,"eng ENG","MF",31,1989,18,37,20,19,17,1,18,33,54.5,15,23,6,17,18,55,19,3,"Matches","https://fbref.com/en/comps/9/2021-2022/defense/2021-2022-Premier-League-Stats"
"Nathaniel Clyne","Crystal Palace",2022,"eng ENG","DF",30,1991,15,21,10,11,9,1,10,20,50,10,7,2,5,15,36,32,0,"Matches","https://fbref.com/en/comps/9/2021-2022/defense/2021-2022-Premier-League-Stats"
"Conor Coady","Wolves",2022,"eng ENG","DF",28,1993,37.3,31,14,23,7,1,16,28,57.1,12,46,40,6,28,59,140,0,"Matches","https://fbref.com/en/comps/9/2021-2022/defense/2021-2022-Premier-League-Stats"
"Séamus Coleman","Everton",2022,"ie IRL","DF",32,1988,29.5,61,36,35,16,10,33,51,64.7,18,30,11,19,32,93,80,2,"Matches","https://fbref.com/en/comps/9/2021-2022/defense/2021-2022-Premier-League-Stats"
"Nathan Collins","Burnley",2022,"ie IRL","DF",20,2001,18.6,37,15,27,8,2,17,27,63,10,38,25,13,24,61,83,2,"Matches","https://fbref.com/en/comps/9/2021-2022/defense/2021-2022-Premier-League-Stats"
"Aaron Connolly","Brighton",2022,"ie IRL","FW,MF",21,2000,1.7,0,0,0,0,0,0,1,0,1,2,0,2,0,0,0,0,"Matches","https://fbref.com/en/comps/9/2021-2022/defense/2021-2022-Premier-League-Stats"
"Liam Cooper","Leeds United",2022,"sct SCO","DF",29,1991,20.2,41,23,27,13,1,23,33,69.7,10,29,18,11,43,84,72,2,"Matches","https://fbref.com/en/comps/9/2021-2022/defense/2021-2022-Premier-League-Stats"
"Jack Cork","Burnley",2022,"eng ENG","MF",32,1989,18.6,20,6,6,11,3,7,20,35,13,17,4,13,17,37,29,1,"Matches","https://fbref.com/en/comps/9/2021-2022/defense/2021-2022-Premier-League-Stats"
"Maxwel Cornet","Burnley",2022,"ci CIV","FW,MF",24,1996,19.6,16,9,7,5,4,7,15,46.7,8,13,4,9,10,26,14,0,"Matches","https://fbref.com/en/comps/9/2021-2022/defense/2021-2022-Premier-League-Stats"
"Hélder Costa","Leeds United",2022,"ao ANG","MF",27,1994,0.2,0,0,0,0,0,0,0,NA,0,1,0,1,0,0,0,0,"Matches","https://fbref.com/en/comps/9/2021-2022/defense/2021-2022-Premier-League-Stats"
"Vladimír Coufal","West Ham",2022,"cz CZE","DF",28,1992,24.5,45,25,24,14,7,18,36,50,18,31,9,22,22,67,64,1,"Matches","https://fbref.com/en/comps/9/2021-2022/defense/2021-2022-Premier-League-Stats"
"Philippe Coutinho","Aston Villa",2022,"br BRA","MF,FW",29,1992,14.8,17,12,4,11,2,6,21,28.6,15,11,1,10,7,24,4,0,"Matches","https://fbref.com/en/comps/9/2021-2022/defense/2021-2022-Premier-League-Stats"
"Aaron Cresswell","West Ham",2022,"eng ENG","DF",31,1989,30.3,28,18,18,6,4,13,25,52,12,31,18,13,35,63,66,0,"Matches","https://fbref.com/en/comps/9/2021-2022/defense/2021-2022-Premier-League-Stats"
"Charlie Cresswell","Leeds United",2022,"eng ENG","DF",18,2002,1.6,5,2,1,4,0,3,3,100,0,1,1,0,2,7,6,0,"Matches","https://fbref.com/en/comps/9/2021-2022/defense/2021-2022-Premier-League-Stats"
"Cucho","Watford",2022,"co COL","FW,MF",22,1999,12.7,13,5,5,5,3,5,27,18.5,22,13,1,12,5,18,9,0,"Matches","https://fbref.com/en/comps/9/2021-2022/defense/2021-2022-Premier-League-Stats"
"Marc Cucurella","Brighton",2022,"es ESP","DF",23,1998,34.3,93,62,43,32,18,44,71,62,27,42,14,28,30,123,74,0,"Matches","https://fbref.com/en/comps/9/2021-2022/defense/2021-2022-Premier-League-Stats"
"Luke Cundle","Wolves",2022,"eng ENG","MF",19,2002,2,4,3,0,4,0,1,1,100,0,0,0,0,1,5,1,0,"Matches","https://fbref.com/en/comps/9/2021-2022/defense/2021-2022-Premier-League-Stats"
"Patson Daka","Leicester City",2022,"zm ZAM","FW",22,1998,12.9,15,10,2,8,5,2,19,10.5,17,7,0,7,2,17,8,0,"Matches","https://fbref.com/en/comps/9/2021-2022/defense/2021-2022-Premier-League-Stats"
"Stuart Dallas","Leeds United",2022,"nir NIR","DF,MF",30,1991,32.4,93,55,58,31,4,56,105,53.3,49,45,14,31,57,150,63,2,"Matches","https://fbref.com/en/comps/9/2021-2022/defense/2021-2022-Premier-League-Stats"
"Diogo Dalot","Manchester Utd",2022,"pt POR","DF",22,1999,20,55,41,35,12,8,31,57,54.4,26,24,13,11,29,84,59,0,"Matches","https://fbref.com/en/comps/9/2021-2022/defense/2021-2022-Premier-League-Stats"
"Karl Darlow","Newcastle Utd",2022,"eng ENG","GK",30,1990,8,0,0,0,0,0,0,0,NA,0,0,0,0,0,0,5,1,"Matches","https://fbref.com/en/comps/9/2021-2022/defense/2021-2022-Premier-League-Stats"
"Josh Dasilva","Brentford",2022,"eng ENG","MF,FW",22,1998,2.9,2,1,0,1,1,1,2,50,1,3,0,3,1,3,7,0,"Matches","https://fbref.com/en/comps/9/2021-2022/defense/2021-2022-Premier-League-Stats"
"Ben Davies","Tottenham",2022,"wls WAL","DF",28,1993,28.2,36,21,20,12,4,13,26,50,13,32,19,13,30,66,75,1,"Matches","https://fbref.com/en/comps/9/2021-2022/defense/2021-2022-Premier-League-Stats"
"Tom Davies","Everton",2022,"eng ENG","MF",23,1998,2.6,3,1,1,1,1,2,5,40,3,2,1,1,2,5,9,0,"Matches","https://fbref.com/en/comps/9/2021-2022/defense/2021-2022-Premier-League-Stats"
"Keinan Davis","Aston Villa",2022,"eng ENG","FW",23,1998,0.1,0,0,0,0,0,0,0,NA,0,0,0,0,0,0,0,0,"Matches","https://fbref.com/en/comps/9/2021-2022/defense/2021-2022-Premier-League-Stats"
"Craig Dawson","West Ham",2022,"eng ENG","DF",31,1990,30.6,29,17,20,8,1,14,25,56,11,59,52,7,29,58,139,0,"Matches","https://fbref.com/en/comps/9/2021-2022/defense/2021-2022-Premier-League-Stats"
"Kevin De Bruyne","Manchester City",2022,"be BEL","MF",30,1991,24.5,32,16,4,15,13,12,37,32.4,25,32,2,30,6,38,16,0,"Matches","https://fbref.com/en/comps/9/2021-2022/defense/2021-2022-Premier-League-Stats"
"Troy Deeney","Watford",2022,"eng ENG","FW",33,1988,0.3,0,0,0,0,0,0,1,0,1,0,0,0,0,0,2,0,"Matches","https://fbref.com/en/comps/9/2021-2022/defense/2021-2022-Premier-League-Stats"
"Liam Delap","Manchester City",2022,"eng ENG","FW",18,2003,0.1,0,0,0,0,0,0,0,NA,0,0,0,0,0,0,0,0,"Matches","https://fbref.com/en/comps/9/2021-2022/defense/2021-2022-Premier-League-Stats"
"Fabian Delph","Everton",2022,"eng ENG","MF",31,1989,7.4,18,15,10,7,1,8,21,38.1,13,12,5,7,14,32,10,0,"Matches","https://fbref.com/en/comps/9/2021-2022/defense/2021-2022-Premier-League-Stats"
"Leander Dendoncker","Wolves",2022,"be BEL","MF",26,1995,21.7,42,17,25,14,3,22,50,44,28,37,10,27,9,51,38,1,"Matches","https://fbref.com/en/comps/9/2021-2022/defense/2021-2022-Premier-League-Stats"
"Emmanuel Dennis","Watford",2022,"ng NGA","FW,MF",23,1997,28.7,51,35,20,22,9,17,52,32.7,35,36,2,34,15,66,13,0,"Matches","https://fbref.com/en/comps/9/2021-2022/defense/2021-2022-Premier-League-Stats"
"Kiernan Dewsbury-Hall","Leicester City",2022,"eng ENG","MF",22,1998,23.4,39,24,20,14,5,19,40,47.5,21,37,8,29,21,60,26,1,"Matches","https://fbref.com/en/comps/9/2021-2022/defense/2021-2022-Premier-League-Stats"
"Ibrahima Diallo","Southampton",2022,"fr FRA","MF",22,1999,11.4,22,11,10,9,3,10,24,41.7,14,7,0,7,9,31,10,0,"Matches","https://fbref.com/en/comps/9/2021-2022/defense/2021-2022-Premier-League-Stats"
"Rúben Dias","Manchester City",2022,"pt POR","DF",24,1997,26.7,26,19,11,12,3,8,15,53.3,7,19,13,6,23,49,66,0,"Matches","https://fbref.com/en/comps/9/2021-2022/defense/2021-2022-Premier-League-Stats"
"Luis Díaz","Liverpool",2022,"co COL","FW",24,1997,10.6,9,7,3,5,1,2,8,25,6,7,0,7,4,13,2,0,"Matches","https://fbref.com/en/comps/9/2021-2022/defense/2021-2022-Premier-League-Stats"
"Eric Dier","Tottenham",2022,"eng ENG","DF",27,1994,34.1,15,9,6,8,1,7,14,50,7,37,32,5,27,42,142,1,"Matches","https://fbref.com/en/comps/9/2021-2022/defense/2021-2022-Premier-League-Stats"
"Lucas Digne","Aston Villa",2022,"fr FRA","DF",28,1993,14.1,13,10,8,3,2,9,19,47.4,10,15,8,7,23,36,40,0,"Matches","https://fbref.com/en/comps/9/2021-2022/defense/2021-2022-Premier-League-Stats"
"Lucas Digne","Everton",2022,"fr FRA","DF",28,1993,13,33,19,26,4,3,21,28,75,7,16,5,11,14,47,30,0,"Matches","https://fbref.com/en/comps/9/2021-2022/defense/2021-2022-Premier-League-Stats"
"Issa Diop","West Ham",2022,"fr FRA","DF",24,1997,10.7,10,8,5,5,0,4,11,36.4,7,14,13,1,7,17,44,0,"Matches","https://fbref.com/en/comps/9/2021-2022/defense/2021-2022-Premier-League-Stats"
"Moussa Djenepo","Southampton",2022,"ml MLI","MF",23,1998,5.1,9,3,3,5,1,3,11,27.3,8,6,1,5,2,11,6,1,"Matches","https://fbref.com/en/comps/9/2021-2022/defense/2021-2022-Premier-League-Stats"
"Lewis Dobbin","Everton",2022,"eng ENG","FW,MF",18,2003,0.4,2,1,0,1,1,1,2,50,1,0,0,0,0,2,0,0,"Matches","https://fbref.com/en/comps/9/2021-2022/defense/2021-2022-Premier-League-Stats"
"Matt Doherty","Tottenham",2022,"ie IRL","DF",29,1992,9.7,18,12,5,11,2,8,14,57.1,6,11,2,9,13,31,20,0,"Matches","https://fbref.com/en/comps/9/2021-2022/defense/2021-2022-Premier-League-Stats"
"Gabriel Dos Santos","Arsenal",2022,"br BRA","DF",23,1997,34,50,30,36,12,2,30,41,73.2,11,34,26,8,13,63,112,4,"Matches","https://fbref.com/en/comps/9/2021-2022/defense/2021-2022-Premier-League-Stats"
"Abdoulaye Doucouré","Everton",2022,"ml MLI","MF",28,1993,28.2,75,43,30,37,8,32,71,45.1,39,33,8,25,28,103,32,0,"Matches","https://fbref.com/en/comps/9/2021-2022/defense/2021-2022-Premier-League-Stats"
"Kieran Dowell","Norwich City",2022,"eng ENG","FW,MF",23,1997,10.1,18,7,8,7,3,9,32,28.1,23,10,1,9,7,25,4,0,"Matches","https://fbref.com/en/comps/9/2021-2022/defense/2021-2022-Premier-League-Stats"
"Cody Drameh","Leeds United",2022,"eng ENG","DF,MF",19,2001,1.4,4,2,3,1,0,1,3,33.3,2,0,0,0,1,5,4,0,"Matches","https://fbref.com/en/comps/9/2021-2022/defense/2021-2022-Premier-League-Stats"
"Martin Dúbravka","Newcastle Utd",2022,"sk SVK","GK",32,1989,26,1,1,1,0,0,0,1,0,1,0,0,0,0,1,8,2,"Matches","https://fbref.com/en/comps/9/2021-2022/defense/2021-2022-Premier-League-Stats"
"Shane Duffy","Brighton",2022,"ie IRL","DF",29,1992,16,15,12,12,3,0,8,14,57.1,6,24,18,6,16,31,76,1,"Matches","https://fbref.com/en/comps/9/2021-2022/defense/2021-2022-Premier-League-Stats"
"Paul Dummett","Newcastle Utd",2022,"wls WAL","DF",29,1991,2.2,7,3,3,4,0,5,8,62.5,3,5,0,5,3,10,5,0,"Matches","https://fbref.com/en/comps/9/2021-2022/defense/2021-2022-Premier-League-Stats"
"Lewis Dunk","Brighton",2022,"eng ENG","DF",29,1991,28.6,10,8,5,5,0,5,11,45.5,6,32,28,4,27,37,113,3,"Matches","https://fbref.com/en/comps/9/2021-2022/defense/2021-2022-Premier-League-Stats"
"Ederson","Manchester City",2022,"br BRA","GK",27,1993,37,2,1,2,0,0,0,2,0,2,0,0,0,0,2,12,0,"Matches","https://fbref.com/en/comps/9/2021-2022/defense/2021-2022-Premier-League-Stats"
"Odsonne Édouard","Crystal Palace",2022,"fr FRA","FW",23,1998,17.4,16,10,2,7,7,7,21,33.3,14,20,5,15,0,16,18,0,"Matches","https://fbref.com/en/comps/9/2021-2022/defense/2021-2022-Premier-League-Stats"
"CJ Egan-Riley","Manchester City",2022,"eng ENG","DF",18,2003,0,1,1,1,0,0,1,1,100,0,0,0,0,0,1,0,0,"Matches","https://fbref.com/en/comps/9/2021-2022/defense/2021-2022-Premier-League-Stats"
"Anthony Elanga","Manchester Utd",2022,"se SWE","FW",19,2002,13.5,26,20,12,12,2,15,29,51.7,14,17,1,16,9,35,7,0,"Matches","https://fbref.com/en/comps/9/2021-2022/defense/2021-2022-Premier-League-Stats"
"Harvey Elliott","Liverpool",2022,"eng ENG","MF",18,2003,3.8,3,0,1,1,1,0,6,0,6,8,1,7,4,7,2,0,"Matches","https://fbref.com/en/comps/9/2021-2022/defense/2021-2022-Premier-League-Stats"
"Mohamed Elneny","Arsenal",2022,"eg EGY","MF",29,1992,9,16,8,10,5,1,7,12,58.3,5,7,1,6,14,30,13,0,"Matches","https://fbref.com/en/comps/9/2021-2022/defense/2021-2022-Premier-League-Stats"
"Mohamed Elyounoussi","Southampton",2022,"no NOR","MF,FW",26,1994,22.7,36,17,14,15,7,11,39,28.2,28,23,2,21,12,48,28,0,"Matches","https://fbref.com/en/comps/9/2021-2022/defense/2021-2022-Premier-League-Stats"
"Emerson","Tottenham",2022,"br BRA","DF,MF",22,1999,25.4,72,47,50,16,6,36,67,53.7,31,25,2,23,22,94,92,1,"Matches","https://fbref.com/en/comps/9/2021-2022/defense/2021-2022-Premier-League-Stats"
"Christian Eriksen","Brentford",2022,"dk DEN","MF",29,1992,10.4,13,6,4,5,4,8,17,47.1,9,9,1,8,9,22,14,0,"Matches","https://fbref.com/en/comps/9/2021-2022/defense/2021-2022-Premier-League-Stats"
"Oghenekaro Etebo","Watford",2022,"ng NGA","MF",25,1995,4.5,11,8,7,4,0,3,8,37.5,5,3,1,2,5,16,5,0,"Matches","https://fbref.com/en/comps/9/2021-2022/defense/2021-2022-Premier-League-Stats"
"Jonny Evans","Leicester City",2022,"nir NIR","DF",33,1988,15,24,14,14,8,2,14,22,63.6,8,17,13,4,20,44,59,0,"Matches","https://fbref.com/en/comps/9/2021-2022/defense/2021-2022-Premier-League-Stats"
"Eberechi Eze","Crystal Palace",2022,"eng ENG","MF,FW",23,1998,6.7,10,6,5,2,3,6,11,54.5,5,4,1,3,5,15,1,0,"Matches","https://fbref.com/en/comps/9/2021-2022/defense/2021-2022-Premier-League-Stats"
"Lukasz Fabianski","West Ham",2022,"pl POL","GK",36,1985,37,0,0,0,0,0,0,0,NA,0,0,0,0,0,0,11,0,"Matches","https://fbref.com/en/comps/9/2021-2022/defense/2021-2022-Premier-League-Stats"
"Fabinho","Liverpool",2022,"br BRA","MF",27,1993,25.7,46,25,17,23,6,24,70,34.3,46,33,10,23,39,85,25,1,"Matches","https://fbref.com/en/comps/9/2021-2022/defense/2021-2022-Premier-League-Stats"
"Kiko Femenía","Watford",2022,"es ESP","DF",30,1991,23.8,35,22,23,10,2,21,37,56.8,16,24,8,16,37,72,51,0,"Matches","https://fbref.com/en/comps/9/2021-2022/defense/2021-2022-Premier-League-Stats"
"Evan Ferguson","Brighton",2022,"ie IRL","MF",16,2004,0.3,0,0,0,0,0,0,0,NA,0,0,0,0,0,0,0,0,"Matches","https://fbref.com/en/comps/9/2021-2022/defense/2021-2022-Premier-League-Stats"
"Nathan Ferguson","Crystal Palace",2022,"eng ENG","DF",20,2000,0.1,0,0,0,0,0,0,0,NA,0,0,0,0,0,0,0,0,"Matches","https://fbref.com/en/comps/9/2021-2022/defense/2021-2022-Premier-League-Stats"
"Bruno Fernandes","Manchester Utd",2022,"pt POR","MF",26,1994,34.6,54,28,26,22,6,26,91,28.6,65,36,0,36,17,71,42,2,"Matches","https://fbref.com/en/comps/9/2021-2022/defense/2021-2022-Premier-League-Stats"
"Álvaro Fernández","Brentford",2022,"es ESP","GK",23,1998,12,0,0,0,0,0,0,0,NA,0,0,0,0,0,0,5,2,"Matches","https://fbref.com/en/comps/9/2021-2022/defense/2021-2022-Premier-League-Stats"
"Federico Fernández","Newcastle Utd",2022,"ar ARG","DF",32,1989,5.8,3,0,3,0,0,2,5,40,3,10,10,0,4,7,28,0,"Matches","https://fbref.com/en/comps/9/2021-2022/defense/2021-2022-Premier-League-Stats"
"Fernandinho","Manchester City",2022,"br BRA","MF,DF",36,1985,10.7,21,10,7,10,4,9,27,33.3,18,8,2,6,8,29,13,1,"Matches","https://fbref.com/en/comps/9/2021-2022/defense/2021-2022-Premier-League-Stats"
"Roberto Firmino","Liverpool",2022,"br BRA","FW",29,1991,11,23,14,5,8,10,3,16,18.8,13,20,0,20,4,27,3,0,"Matches","https://fbref.com/en/comps/9/2021-2022/defense/2021-2022-Premier-League-Stats"
"Junior Firpo","Leeds United",2022,"es ESP","DF,MF",24,1996,19,61,29,30,26,5,31,59,52.5,28,22,6,16,24,85,37,0,"Matches","https://fbref.com/en/comps/9/2021-2022/defense/2021-2022-Premier-League-Stats"
"Ashley Fletcher","Watford",2022,"eng ENG","FW",25,1995,0.3,2,1,1,1,0,1,1,100,0,1,1,0,0,2,0,0,"Matches","https://fbref.com/en/comps/9/2021-2022/defense/2021-2022-Premier-League-Stats"
"Phil Foden","Manchester City",2022,"eng ENG","FW",21,2000,23.6,16,8,10,4,2,7,17,41.2,10,9,0,9,11,27,5,0,"Matches","https://fbref.com/en/comps/9/2021-2022/defense/2021-2022-Premier-League-Stats"
"Wesley Fofana","Leicester City",2022,"fr FRA","DF",20,2000,7,12,8,11,1,0,7,11,63.6,4,5,2,3,12,24,26,1,"Matches","https://fbref.com/en/comps/9/2021-2022/defense/2021-2022-Premier-League-Stats"
"Pablo Fornals","West Ham",2022,"es ESP","FW,MF",25,1996,31.1,54,28,21,21,12,22,84,26.2,62,49,2,47,27,81,16,1,"Matches","https://fbref.com/en/comps/9/2021-2022/defense/2021-2022-Premier-League-Stats"
"Adam Forshaw","Leeds United",2022,"eng ENG","MF",29,1991,17,53,23,21,27,5,21,54,38.9,33,17,1,16,19,72,12,2,"Matches","https://fbref.com/en/comps/9/2021-2022/defense/2021-2022-Premier-League-Stats"
"Marcus Forss","Brentford",2022,"fi FIN","FW,MF",22,1999,2.3,3,3,0,2,1,2,4,50,2,5,0,5,1,4,0,0,"Matches","https://fbref.com/en/comps/9/2021-2022/defense/2021-2022-Premier-League-Stats"
"Fraser Forster","Southampton",2022,"eng ENG","GK",33,1988,19,1,0,1,0,0,0,1,0,1,0,0,0,0,1,23,2,"Matches","https://fbref.com/en/comps/9/2021-2022/defense/2021-2022-Premier-League-Stats"
"Ben Foster","Watford",2022,"eng ENG","GK",38,1983,26,0,0,0,0,0,0,3,0,3,0,0,0,0,0,9,4,"Matches","https://fbref.com/en/comps/9/2021-2022/defense/2021-2022-Premier-League-Stats"
"Tariqe Fosu","Brentford",2022,"gh GHA","DF",25,1995,0.2,0,0,0,0,0,0,0,NA,0,1,0,1,0,0,0,0,"Matches","https://fbref.com/en/comps/9/2021-2022/defense/2021-2022-Premier-League-Stats"
"Ryan Fraser","Newcastle Utd",2022,"sct SCO","FW,MF",27,1994,16.3,10,3,5,3,2,5,13,38.5,8,11,1,10,11,21,11,0,"Matches","https://fbref.com/en/comps/9/2021-2022/defense/2021-2022-Premier-League-Stats"
"Fred","Manchester Utd",2022,"br BRA","MF",28,1993,22.5,63,27,32,24,7,22,79,27.8,57,38,11,27,32,95,24,0,"Matches","https://fbref.com/en/comps/9/2021-2022/defense/2021-2022-Premier-League-Stats"
"Ryan Fredericks","West Ham",2022,"eng ENG","DF",28,1992,3.4,2,2,2,0,0,0,1,0,1,2,1,1,4,6,6,0,"Matches","https://fbref.com/en/comps/9/2021-2022/defense/2021-2022-Premier-League-Stats"
"Leo Fuhr Hjelde","Leeds United",2022,"no NOR","MF,DF",17,2003,1.7,5,4,3,2,0,3,3,100,0,3,3,0,4,9,7,0,"Matches","https://fbref.com/en/comps/9/2021-2022/defense/2021-2022-Premier-League-Stats"
"Conor Gallagher","Crystal Palace",2022,"eng ENG","MF",21,2000,31.6,69,38,35,20,14,21,69,30.4,48,58,9,49,29,98,26,0,"Matches","https://fbref.com/en/comps/9/2021-2022/defense/2021-2022-Premier-League-Stats"
"Alejandro Garnacho","Manchester Utd",2022,"ar ARG","FW,MF",17,2004,0.1,0,0,0,0,0,0,1,0,1,0,0,0,0,0,0,0,"Matches","https://fbref.com/en/comps/9/2021-2022/defense/2021-2022-Premier-League-Stats"
"Dwight Gayle","Newcastle Utd",2022,"eng ENG","FW,DF",30,1990,0.4,1,0,0,1,0,0,1,0,1,0,0,0,1,2,0,0,"Matches","https://fbref.com/en/comps/9/2021-2022/defense/2021-2022-Premier-League-Stats"
"Jean-Philippe Gbamin","Everton",2022,"ci CIV","MF",25,1995,0.7,1,1,1,0,0,0,2,0,2,0,0,0,1,2,1,0,"Matches","https://fbref.com/en/comps/9/2021-2022/defense/2021-2022-Premier-League-Stats"
"David de Gea","Manchester Utd",2022,"es ESP","GK",30,1990,38,0,0,0,0,0,0,0,NA,0,0,0,0,0,0,11,2,"Matches","https://fbref.com/en/comps/9/2021-2022/defense/2021-2022-Premier-League-Stats"
"Joe Gelhardt","Leeds United",2022,"eng ENG","FW,MF",19,2002,8.3,4,3,1,0,3,2,10,20,8,9,0,9,0,4,3,0,"Matches","https://fbref.com/en/comps/9/2021-2022/defense/2021-2022-Premier-League-Stats"
"Anwar El Ghazi","Aston Villa",2022,"nl NED","FW,MF",26,1995,4.3,4,4,2,2,0,2,7,28.6,5,6,0,6,1,5,2,0,"Matches","https://fbref.com/en/comps/9/2021-2022/defense/2021-2022-Premier-League-Stats"
"Anwar El Ghazi","Everton",2022,"nl NED","FW,MF",26,1995,0.1,1,1,1,0,0,1,1,100,0,3,0,3,0,1,0,0,"Matches","https://fbref.com/en/comps/9/2021-2022/defense/2021-2022-Premier-League-Stats"
"Saman Ghoddos","Brentford",2022,"ir IRN","MF,DF",27,1993,6,17,10,8,6,3,9,15,60,6,2,0,2,3,20,16,0,"Matches","https://fbref.com/en/comps/9/2021-2022/defense/2021-2022-Premier-League-Stats"
"Dimitris Giannoulis","Norwich City",2022,"gr GRE","DF",25,1995,13,36,21,17,17,2,24,36,66.7,12,22,6,16,19,55,41,1,"Matches","https://fbref.com/en/comps/9/2021-2022/defense/2021-2022-Premier-League-Stats"
"Morgan Gibbs-White","Wolves",2022,"eng ENG","DF,FW",21,2000,0.1,0,0,0,0,0,0,0,NA,0,1,0,1,0,0,0,0,"Matches","https://fbref.com/en/comps/9/2021-2022/defense/2021-2022-Premier-League-Stats"
"Ben Gibson","Norwich City",2022,"eng ENG","DF",28,1993,27.7,23,16,17,6,0,7,12,58.3,5,36,30,6,27,50,139,2,"Matches","https://fbref.com/en/comps/9/2021-2022/defense/2021-2022-Premier-League-Stats"
"Billy Gilmour","Norwich City",2022,"sct SCO","MF",20,2001,20.6,41,21,16,21,4,14,52,26.9,38,21,4,17,17,58,29,0,"Matches","https://fbref.com/en/comps/9/2021-2022/defense/2021-2022-Premier-League-Stats"
"Ben Godfrey","Everton",2022,"eng ENG","DF",23,1998,22.5,47,32,29,14,4,24,39,61.5,15,41,19,22,15,62,100,2,"Matches","https://fbref.com/en/comps/9/2021-2022/defense/2021-2022-Premier-League-Stats"
"André Gomes","Everton",2022,"pt POR","MF",28,1993,6.9,16,4,6,6,4,8,32,25,24,8,2,6,1,17,7,1,"Matches","https://fbref.com/en/comps/9/2021-2022/defense/2021-2022-Premier-League-Stats"
"Toti Gomes","Wolves",2022,"pt POR","DF",22,1999,4,11,7,10,1,0,7,9,77.8,2,6,3,3,8,19,15,0,"Matches","https://fbref.com/en/comps/9/2021-2022/defense/2021-2022-Premier-League-Stats"
"Joe Gomez","Liverpool",2022,"eng ENG","DF",24,1997,3.7,10,6,5,2,3,5,9,55.6,4,4,1,3,5,15,6,0,"Matches","https://fbref.com/en/comps/9/2021-2022/defense/2021-2022-Premier-League-Stats"
"Charlie Goode","Brentford",2022,"eng ENG","DF",25,1995,5,7,5,5,2,0,4,4,100,0,4,2,2,2,9,8,0,"Matches","https://fbref.com/en/comps/9/2021-2022/defense/2021-2022-Premier-League-Stats"
"Anthony Gordon","Everton",2022,"eng ENG","MF,FW",20,2001,25.4,54,32,20,30,4,21,59,35.6,38,49,3,46,22,76,17,0,"Matches","https://fbref.com/en/comps/9/2021-2022/defense/2021-2022-Premier-League-Stats"
"Kaide Gordon","Liverpool",2022,"eng ENG","FW",16,2004,0.1,1,0,0,0,1,0,0,NA,0,0,0,0,0,1,0,0,"Matches","https://fbref.com/en/comps/9/2021-2022/defense/2021-2022-Premier-League-Stats"
"Dan Gosling","Watford",2022,"eng ENG","MF",31,1990,1.8,2,1,1,1,0,2,6,33.3,4,2,0,2,0,2,3,0,"Matches","https://fbref.com/en/comps/9/2021-2022/defense/2021-2022-Premier-League-Stats"
"Demarai Gray","Everton",2022,"eng ENG","MF,FW",25,1996,26,30,19,13,10,7,10,22,45.5,12,30,2,28,15,45,21,1,"Matches","https://fbref.com/en/comps/9/2021-2022/defense/2021-2022-Premier-League-Stats"
"Jack Grealish","Manchester City",2022,"eng ENG","FW",25,1995,21.3,18,17,4,10,4,5,13,38.5,8,11,1,10,8,26,7,0,"Matches","https://fbref.com/en/comps/9/2021-2022/defense/2021-2022-Premier-League-Stats"
"Mason Greenwood","Manchester Utd",2022,"eng ENG","FW,MF",19,2001,14.1,15,9,9,1,5,3,9,33.3,6,5,0,5,1,16,6,0,"Matches","https://fbref.com/en/comps/9/2021-2022/defense/2021-2022-Premier-League-Stats"
"Sam Greenwood","Leeds United",2022,"eng ENG","MF,FW",19,2002,2.6,8,5,0,5,3,4,7,57.1,3,3,0,3,2,10,1,0,"Matches","https://fbref.com/en/comps/9/2021-2022/defense/2021-2022-Premier-League-Stats"
"Pascal Groß","Brighton",2022,"de GER","MF,DF",30,1991,22.6,28,15,15,11,2,12,33,36.4,21,34,8,26,18,46,23,0,"Matches","https://fbref.com/en/comps/9/2021-2022/defense/2021-2022-Premier-League-Stats"
"Vicente Guaita","Crystal Palace",2022,"es ESP","GK",34,1987,29.5,1,0,1,0,0,1,1,100,0,0,0,0,1,2,8,1,"Matches","https://fbref.com/en/comps/9/2021-2022/defense/2021-2022-Premier-League-Stats"
"Marc Guéhi","Crystal Palace",2022,"eng ENG","DF",21,2000,35.8,35,17,24,10,1,15,16,93.8,1,34,26,8,30,65,127,0,"Matches","https://fbref.com/en/comps/9/2021-2022/defense/2021-2022-Premier-League-Stats"
"Bruno Guimarães","Newcastle Utd",2022,"br BRA","MF",23,1997,11.5,44,23,18,22,4,21,38,55.3,17,25,6,19,9,53,13,0,"Matches","https://fbref.com/en/comps/9/2021-2022/defense/2021-2022-Premier-League-Stats"
"Ilkay Gündogan","Manchester City",2022,"de GER","MF",30,1990,20.6,23,9,10,12,1,12,31,38.7,19,11,1,10,15,38,10,0,"Matches","https://fbref.com/en/comps/9/2021-2022/defense/2021-2022-Premier-League-Stats"
"Angus Gunn","Norwich City",2022,"sct SCO","GK",25,1996,9,0,0,0,0,0,0,0,NA,0,0,0,0,0,0,11,0,"Matches","https://fbref.com/en/comps/9/2021-2022/defense/2021-2022-Premier-League-Stats"
"Grant Hanley","Norwich City",2022,"sct SCO","DF",29,1991,32.2,44,25,28,14,2,18,35,51.4,17,56,45,11,56,100,176,2,"Matches","https://fbref.com/en/comps/9/2021-2022/defense/2021-2022-Premier-League-Stats"
"Jack Harrison","Leeds United",2022,"eng ENG","FW,MF",24,1996,29.3,57,37,22,22,13,31,76,40.8,45,35,1,34,21,78,19,0,"Matches","https://fbref.com/en/comps/9/2021-2022/defense/2021-2022-Premier-League-Stats"
"Kortney Hause","Aston Villa",2022,"eng ENG","DF",26,1995,4.4,3,3,2,0,1,3,4,75,1,8,5,3,6,9,13,0,"Matches","https://fbref.com/en/comps/9/2021-2022/defense/2021-2022-Premier-League-Stats"
"Kai Havertz","Chelsea",2022,"de GER","FW,MF",22,1999,20.1,17,8,5,7,5,4,14,28.6,10,28,1,27,4,21,32,1,"Matches","https://fbref.com/en/comps/9/2021-2022/defense/2021-2022-Premier-League-Stats"
"Isaac Hayden","Newcastle Utd",2022,"eng ENG","MF,DF",26,1995,11.1,28,14,11,14,3,12,29,41.4,17,17,8,9,14,42,24,0,"Matches","https://fbref.com/en/comps/9/2021-2022/defense/2021-2022-Premier-League-Stats"
"Hwang Hee-chan","Wolves",2022,"kr KOR","FW,MF",25,1996,20.2,27,13,9,16,2,14,44,31.8,30,10,0,10,13,40,7,1,"Matches","https://fbref.com/en/comps/9/2021-2022/defense/2021-2022-Premier-League-Stats"
"Jordan Henderson","Liverpool",2022,"eng ENG","MF",31,1990,28.9,36,20,9,25,2,17,44,38.6,27,25,1,24,23,59,14,0,"Matches","https://fbref.com/en/comps/9/2021-2022/defense/2021-2022-Premier-League-Stats"
"Jeff Hendrick","Newcastle Utd",2022,"ie IRL","MF",29,1992,0.8,1,1,0,1,0,1,1,100,0,0,0,0,0,1,1,0,"Matches","https://fbref.com/en/comps/9/2021-2022/defense/2021-2022-Premier-League-Stats"
"Wayne Hennessey","Burnley",2022,"wls WAL","GK",34,1987,2,0,0,0,0,0,0,0,NA,0,0,0,0,1,1,0,1,"Matches","https://fbref.com/en/comps/9/2021-2022/defense/2021-2022-Premier-League-Stats"
"Rico Henry","Brentford",2022,"eng ENG","DF",24,1997,30.8,28,20,18,8,2,12,34,35.3,22,31,10,21,26,54,76,1,"Matches","https://fbref.com/en/comps/9/2021-2022/defense/2021-2022-Premier-League-Stats"
"Son Heung-min","Tottenham",2022,"kr KOR","MF,FW",29,1992,33.4,15,6,5,7,3,5,23,21.7,18,27,6,21,13,28,8,0,"Matches","https://fbref.com/en/comps/9/2021-2022/defense/2021-2022-Premier-League-Stats"
"Ki-Jana Hoever","Wolves",2022,"nl NED","DF,MF",19,2002,3.4,10,6,5,5,0,7,12,58.3,5,6,0,6,6,16,8,0,"Matches","https://fbref.com/en/comps/9/2021-2022/defense/2021-2022-Premier-League-Stats"
"Rob Holding","Arsenal",2022,"eng ENG","DF",25,1995,9.4,13,9,11,1,1,5,6,83.3,1,23,18,5,10,23,42,1,"Matches","https://fbref.com/en/comps/9/2021-2022/defense/2021-2022-Premier-League-Stats"
"Mason Holgate","Everton",2022,"eng ENG","DF",24,1996,23.7,35,18,26,9,0,11,26,42.3,15,25,17,8,26,61,95,1,"Matches","https://fbref.com/en/comps/9/2021-2022/defense/2021-2022-Premier-League-Stats"
"Callum Hudson-Odoi","Chelsea",2022,"eng ENG","MF,FW",20,2000,10.7,14,10,5,6,3,8,23,34.8,15,8,0,8,2,16,6,1,"Matches","https://fbref.com/en/comps/9/2021-2022/defense/2021-2022-Premier-League-Stats"
"Will Hughes","Crystal Palace",2022,"eng ENG","MF",26,1995,11.7,29,14,10,16,3,7,16,43.8,9,13,7,6,8,37,10,0,"Matches","https://fbref.com/en/comps/9/2021-2022/defense/2021-2022-Premier-League-Stats"
"Pierre Højbjerg","Tottenham",2022,"dk DEN","MF",25,1995,35.5,78,45,31,38,9,38,85,44.7,47,61,13,48,48,126,54,0,"Matches","https://fbref.com/en/comps/9/2021-2022/defense/2021-2022-Premier-League-Stats"
"Adam Idah","Norwich City",2022,"ie IRL","FW,MF",20,2001,6.9,9,6,2,5,2,2,3,66.7,1,4,2,2,3,12,7,0,"Matches","https://fbref.com/en/comps/9/2021-2022/defense/2021-2022-Premier-League-Stats"
"Kelechi Iheanacho","Leicester City",2022,"ng NGA","FW",24,1996,14,10,7,2,5,3,3,14,21.4,11,19,0,19,4,14,10,0,"Matches","https://fbref.com/en/comps/9/2021-2022/defense/2021-2022-Premier-League-Stats"
"Danny Ings","Aston Villa",2022,"eng ENG","FW",29,1992,21.1,23,16,2,16,5,13,37,35.1,24,31,2,29,6,29,22,0,"Matches","https://fbref.com/en/comps/9/2021-2022/defense/2021-2022-Premier-League-Stats"
"Tim Iroegbunam","Aston Villa",2022,"eng ENG","MF",18,2003,1,5,4,2,3,0,1,1,100,0,0,0,0,2,7,1,0,"Matches","https://fbref.com/en/comps/9/2021-2022/defense/2021-2022-Premier-League-Stats"
"Alex Iwobi","Everton",2022,"ng NGA","MF,DF",25,1996,22.6,40,19,23,12,5,21,52,40.4,31,39,3,36,20,60,25,2,"Matches","https://fbref.com/en/comps/9/2021-2022/defense/2021-2022-Premier-League-Stats"
"Daniel James","Manchester Utd",2022,"wls WAL","FW",23,1997,1.4,2,1,0,2,0,0,0,NA,0,2,0,2,0,2,1,0,"Matches","https://fbref.com/en/comps/9/2021-2022/defense/2021-2022-Premier-League-Stats"
"Daniel James","Leeds United",2022,"wls WAL","FW,MF",23,1997,26.3,24,14,8,8,8,10,23,43.5,13,18,1,17,8,32,12,0,"Matches","https://fbref.com/en/comps/9/2021-2022/defense/2021-2022-Premier-League-Stats"
"Reece James","Chelsea",2022,"eng ENG","DF",21,1999,20.7,33,25,14,18,1,9,22,40.9,13,20,2,18,17,50,22,0,"Matches","https://fbref.com/en/comps/9/2021-2022/defense/2021-2022-Premier-League-Stats"
"Vitaly Janelt","Brentford",2022,"de GER","MF",23,1998,25.5,61,32,26,27,8,27,53,50.9,26,23,7,16,28,89,35,0,"Matches","https://fbref.com/en/comps/9/2021-2022/defense/2021-2022-Premier-League-Stats"
"Pontus Jansson","Brentford",2022,"se SWE","DF",30,1991,36.9,40,21,32,8,0,22,34,64.7,12,37,27,10,52,92,187,0,"Matches","https://fbref.com/en/comps/9/2021-2022/defense/2021-2022-Premier-League-Stats"
"Mathias Jensen","Brentford",2022,"dk DEN","MF",25,1996,17.8,33,18,12,16,5,22,63,34.9,41,32,3,29,22,55,13,0,"Matches","https://fbref.com/en/comps/9/2021-2022/defense/2021-2022-Premier-League-Stats"
"Gabriel Jesus","Manchester City",2022,"br BRA","FW",24,1997,20.9,18,12,2,4,12,6,26,23.1,20,18,0,18,15,33,8,0,"Matches","https://fbref.com/en/comps/9/2021-2022/defense/2021-2022-Premier-League-Stats"
"Raúl Jiménez","Wolves",2022,"mx MEX","FW",30,1991,29.2,29,14,6,16,7,6,30,20,24,31,5,26,13,42,26,0,"Matches","https://fbref.com/en/comps/9/2021-2022/defense/2021-2022-Premier-League-Stats"
"João Pedro","Watford",2022,"br BRA","FW,MF",19,2001,18.3,20,14,7,8,5,6,23,26.1,17,23,3,20,15,35,17,0,"Matches","https://fbref.com/en/comps/9/2021-2022/defense/2021-2022-Premier-League-Stats"
"Joelinton","Newcastle Utd",2022,"br BRA","MF,FW",24,1996,28.4,72,38,30,33,9,26,61,42.6,35,46,11,35,34,106,50,2,"Matches","https://fbref.com/en/comps/9/2021-2022/defense/2021-2022-Premier-League-Stats"
"Ben Johnson","West Ham",2022,"eng ENG","DF",21,2000,15.5,33,16,15,15,3,21,28,75,7,16,8,8,22,55,55,0,"Matches","https://fbref.com/en/comps/9/2021-2022/defense/2021-2022-Premier-League-Stats"
"Curtis Jones","Liverpool",2022,"eng ENG","MF",20,2001,9.5,11,9,3,6,2,1,10,10,9,4,0,4,6,17,4,0,"Matches","https://fbref.com/en/comps/9/2021-2022/defense/2021-2022-Premier-League-Stats"
"Phil Jones","Manchester Utd",2022,"eng ENG","DF",29,1992,1.8,5,5,3,1,1,2,3,66.7,1,4,4,0,3,8,8,0,"Matches","https://fbref.com/en/comps/9/2021-2022/defense/2021-2022-Premier-League-Stats"
"Jorginho","Chelsea",2022,"it ITA","MF",29,1991,25.3,64,33,27,31,6,29,83,34.9,54,27,4,23,36,100,21,1,"Matches","https://fbref.com/en/comps/9/2021-2022/defense/2021-2022-Premier-League-Stats"
"Diogo Jota","Liverpool",2022,"pt POR","FW",24,1996,26.3,39,18,12,18,9,13,55,23.6,42,19,2,17,6,45,6,0,"Matches","https://fbref.com/en/comps/9/2021-2022/defense/2021-2022-Premier-League-Stats"
"James Justin","Leicester City",2022,"eng ENG","DF",23,1998,11.1,22,13,11,8,3,7,15,46.7,8,16,4,12,17,39,34,0,"Matches","https://fbref.com/en/comps/9/2021-2022/defense/2021-2022-Premier-League-Stats"
"Mathias Jørgensen","Brentford",2022,"dk DEN","DF",31,1990,5.8,10,4,3,5,2,7,10,70,3,6,1,5,10,20,13,0,"Matches","https://fbref.com/en/comps/9/2021-2022/defense/2021-2022-Premier-League-Stats"
"Ozan Kabak","Norwich City",2022,"tr TUR","DF",21,2000,10.2,10,5,4,6,0,5,9,55.6,4,19,11,8,16,26,26,0,"Matches","https://fbref.com/en/comps/9/2021-2022/defense/2021-2022-Premier-League-Stats"
"Christian Kabasele","Watford",2022,"be BEL","DF",30,1991,13.3,11,5,10,1,0,7,10,70,3,20,16,4,14,25,67,1,"Matches","https://fbref.com/en/comps/9/2021-2022/defense/2021-2022-Premier-League-Stats"
"Samuel Kalu","Watford",2022,"ng NGA","FW",23,1997,2.5,2,2,0,2,0,1,1,100,0,2,0,2,3,5,3,0,"Matches","https://fbref.com/en/comps/9/2021-2022/defense/2021-2022-Premier-League-Stats"
"Hassane Kamara","Watford",2022,"ci CIV","DF",27,1994,18,53,34,31,16,6,27,43,62.8,16,20,4,16,69,122,67,0,"Matches","https://fbref.com/en/comps/9/2021-2022/defense/2021-2022-Premier-League-Stats"
"Harry Kane","Tottenham",2022,"eng ENG","FW",28,1993,35.9,15,5,2,10,3,7,18,38.9,11,26,8,18,3,18,39,0,"Matches","https://fbref.com/en/comps/9/2021-2022/defense/2021-2022-Premier-League-Stats"
"N'Golo Kanté","Chelsea",2022,"fr FRA","MF",30,1991,19.7,59,31,20,27,12,25,40,62.5,15,37,2,35,31,90,8,0,"Matches","https://fbref.com/en/comps/9/2021-2022/defense/2021-2022-Premier-League-Stats"
"Edo Kayembe","Watford",2022,"cd COD","MF",23,1998,8.9,21,13,11,9,1,8,16,50,8,6,1,5,9,30,13,0,"Matches","https://fbref.com/en/comps/9/2021-2022/defense/2021-2022-Premier-League-Stats"
"Moise Kean","Everton",2022,"it ITA","FW",21,2000,0,0,0,0,0,0,0,0,NA,0,0,0,0,0,0,0,0,"Matches","https://fbref.com/en/comps/9/2021-2022/defense/2021-2022-Premier-League-Stats"
"Michael Keane","Everton",2022,"eng ENG","DF",28,1993,31,46,25,32,13,1,28,45,62.2,17,33,28,5,62,108,128,2,"Matches","https://fbref.com/en/comps/9/2021-2022/defense/2021-2022-Premier-League-Stats"
"Naby Keïta","Liverpool",2022,"gn GUI","MF",26,1995,13,46,23,17,19,10,26,42,61.9,16,33,2,31,14,60,8,0,"Matches","https://fbref.com/en/comps/9/2021-2022/defense/2021-2022-Premier-League-Stats"
"Caoimhín Kelleher","Liverpool",2022,"ie IRL","GK",22,1998,2,1,1,1,0,0,1,1,100,0,0,0,0,0,1,1,0,"Matches","https://fbref.com/en/comps/9/2021-2022/defense/2021-2022-Premier-League-Stats"
"Kenedy","Chelsea",2022,"br BRA","DF",25,1996,0.6,5,2,1,2,2,2,3,66.7,1,0,0,0,0,5,0,0,"Matches","https://fbref.com/en/comps/9/2021-2022/defense/2021-2022-Premier-League-Stats"
"Jonjoe Kenny","Everton",2022,"eng ENG","DF",24,1997,11.3,17,7,11,6,0,13,21,61.9,8,8,1,7,20,37,31,0,"Matches","https://fbref.com/en/comps/9/2021-2022/defense/2021-2022-Premier-League-Stats"
"Max Kilman","Wolves",2022,"eng ENG","DF",24,1997,29.9,50,26,38,10,2,24,37,64.9,13,36,21,15,45,95,113,3,"Matches","https://fbref.com/en/comps/9/2021-2022/defense/2021-2022-Premier-League-Stats"
"Joshua King","Watford",2022,"no NOR","FW",29,1992,25,19,15,7,6,6,4,17,23.5,13,15,4,11,8,27,31,0,"Matches","https://fbref.com/en/comps/9/2021-2022/defense/2021-2022-Premier-League-Stats"
"Kristoffer Klaesson","Leeds United",2022,"no NOR","GK",20,2000,0.4,0,0,0,0,0,0,0,NA,0,0,0,0,0,0,0,0,"Matches","https://fbref.com/en/comps/9/2021-2022/defense/2021-2022-Premier-League-Stats"
"Mateusz Klich","Leeds United",2022,"pl POL","MF",31,1990,23,47,25,18,23,6,25,66,37.9,41,22,4,18,11,58,20,0,"Matches","https://fbref.com/en/comps/9/2021-2022/defense/2021-2022-Premier-League-Stats"
"Robin Koch","Leeds United",2022,"de GER","MF,DF",25,1996,17.5,21,13,9,10,2,9,34,26.5,25,26,10,16,20,41,44,0,"Matches","https://fbref.com/en/comps/9/2021-2022/defense/2021-2022-Premier-League-Stats"
"Sead Kolainac","Arsenal",2022,"ba BIH","DF",28,1993,1,0,0,0,0,0,0,0,NA,0,0,0,0,4,4,1,0,"Matches","https://fbref.com/en/comps/9/2021-2022/defense/2021-2022-Premier-League-Stats"
"Ibrahima Konaté","Liverpool",2022,"fr FRA","DF",22,1999,11,16,10,9,6,1,7,10,70,3,13,9,4,16,32,37,1,"Matches","https://fbref.com/en/comps/9/2021-2022/defense/2021-2022-Premier-League-Stats"
"Ezri Konsa","Aston Villa",2022,"eng ENG","DF",23,1997,27.5,25,15,13,11,1,10,13,76.9,3,31,22,9,15,40,86,2,"Matches","https://fbref.com/en/comps/9/2021-2022/defense/2021-2022-Premier-League-Stats"
"Cheikhou Kouyaté","Crystal Palace",2022,"sn SEN","MF",31,1989,21.9,52,38,28,22,2,18,39,46.2,21,40,14,26,38,90,39,0,"Matches","https://fbref.com/en/comps/9/2021-2022/defense/2021-2022-Premier-League-Stats"
"Mateo Kovacic","Chelsea",2022,"hr CRO","MF",27,1994,17.3,51,31,14,26,11,17,35,48.6,18,19,4,15,7,58,9,1,"Matches","https://fbref.com/en/comps/9/2021-2022/defense/2021-2022-Premier-League-Stats"
"Emil Krafth","Newcastle Utd",2022,"se SWE","DF",26,1994,18.2,37,16,25,11,1,27,36,75,9,16,10,6,25,62,56,0,"Matches","https://fbref.com/en/comps/9/2021-2022/defense/2021-2022-Premier-League-Stats"
"Alex Král","West Ham",2022,"cz CZE","MF",23,1998,0,0,0,0,0,0,0,0,NA,0,0,0,0,0,0,0,0,"Matches","https://fbref.com/en/comps/9/2021-2022/defense/2021-2022-Premier-League-Stats"
"Tim Krul","Norwich City",2022,"nl NED","GK",33,1988,29,1,1,1,0,0,1,4,25,3,0,0,0,0,1,10,4,"Matches","https://fbref.com/en/comps/9/2021-2022/defense/2021-2022-Premier-League-Stats"
"Juraj Kucka","Watford",2022,"sk SVK","MF",34,1987,21.3,59,39,32,25,2,27,73,37,46,30,9,21,27,86,46,2,"Matches","https://fbref.com/en/comps/9/2021-2022/defense/2021-2022-Premier-League-Stats"
"Dejan Kulusevski","Tottenham",2022,"se SWE","MF,FW",21,2000,14,19,13,7,10,2,5,23,21.7,18,14,0,14,13,32,3,0,"Matches","https://fbref.com/en/comps/9/2021-2022/defense/2021-2022-Premier-League-Stats"
"Alexandre Lacazette","Arsenal",2022,"fr FRA","FW",30,1991,19.8,27,10,8,13,6,7,21,33.3,14,12,1,11,5,32,6,0,"Matches","https://fbref.com/en/comps/9/2021-2022/defense/2021-2022-Premier-League-Stats"
"Adam Lallana","Brighton",2022,"eng ENG","MF",33,1988,17.3,34,17,14,14,6,12,41,29.3,29,16,6,10,16,50,13,1,"Matches","https://fbref.com/en/comps/9/2021-2022/defense/2021-2022-Premier-League-Stats"
"Tariq Lamptey","Brighton",2022,"gh GHA","DF,FW",20,2000,17.3,36,25,14,17,5,15,25,60,10,13,3,10,21,57,23,0,"Matches","https://fbref.com/en/comps/9/2021-2022/defense/2021-2022-Premier-League-Stats"
"Manuel Lanzini","West Ham",2022,"ar ARG","MF,FW",28,1993,19.8,28,15,10,11,7,10,35,28.6,25,16,0,16,19,47,10,0,"Matches","https://fbref.com/en/comps/9/2021-2022/defense/2021-2022-Premier-League-Stats"
"Aymeric Laporte","Manchester City",2022,"es ESP","DF",27,1994,31.4,33,15,22,10,1,14,20,70,6,15,10,5,20,53,64,2,"Matches","https://fbref.com/en/comps/9/2021-2022/defense/2021-2022-Premier-League-Stats"
"Jamaal Lascelles","Newcastle Utd",2022,"eng ENG","DF",27,1993,22.9,15,7,9,5,1,4,12,33.3,8,38,28,10,22,37,121,1,"Matches","https://fbref.com/en/comps/9/2021-2022/defense/2021-2022-Premier-League-Stats"
"Pierre Lees-Melou","Norwich City",2022,"fr FRA","MF",28,1993,25.2,58,36,23,29,6,25,92,27.2,67,37,11,26,25,83,23,0,"Matches","https://fbref.com/en/comps/9/2021-2022/defense/2021-2022-Premier-League-Stats"
"Aaron Lennon","Burnley",2022,"eng ENG","MF,FW",34,1987,17.2,33,17,10,13,10,10,34,29.4,24,26,4,22,9,42,14,0,"Matches","https://fbref.com/en/comps/9/2021-2022/defense/2021-2022-Premier-League-Stats"
"Bernd Leno","Arsenal",2022,"de GER","GK",29,1992,4,1,1,1,0,0,1,1,100,0,0,0,0,0,1,1,0,"Matches","https://fbref.com/en/comps/9/2021-2022/defense/2021-2022-Premier-League-Stats"
"Jamal Lewis","Newcastle Utd",2022,"nir NIR","DF",23,1998,2.9,8,6,6,1,1,3,4,75,1,3,2,1,3,11,8,0,"Matches","https://fbref.com/en/comps/9/2021-2022/defense/2021-2022-Premier-League-Stats"
"Victor Lindelöf","Manchester Utd",2022,"se SWE","DF",27,1994,26.2,16,11,9,7,0,9,14,64.3,5,26,17,9,25,41,96,0,"Matches","https://fbref.com/en/comps/9/2021-2022/defense/2021-2022-Premier-League-Stats"
"Jesse Lingard","Manchester Utd",2022,"eng ENG","FW,MF",28,1992,4.1,9,7,4,3,2,2,6,33.3,4,4,0,4,0,9,1,0,"Matches","https://fbref.com/en/comps/9/2021-2022/defense/2021-2022-Premier-League-Stats"
"Valentino Livramento","Southampton",2022,"eng ENG","DF",18,2002,24.5,54,28,30,18,6,27,45,60,18,23,9,14,47,101,50,1,"Matches","https://fbref.com/en/comps/9/2021-2022/defense/2021-2022-Premier-League-Stats"
"Diego Llorente","Leeds United",2022,"es ESP","DF",27,1993,26,53,31,32,19,2,33,47,70.2,14,35,17,18,40,93,77,2,"Matches","https://fbref.com/en/comps/9/2021-2022/defense/2021-2022-Premier-League-Stats"
"Hugo Lloris","Tottenham",2022,"fr FRA","GK",34,1986,38,1,1,1,0,0,1,2,50,1,0,0,0,1,2,24,3,"Matches","https://fbref.com/en/comps/9/2021-2022/defense/2021-2022-Premier-League-Stats"
"Giovani Lo Celso","Tottenham",2022,"ar ARG","MF,FW",25,1996,2.6,8,4,4,2,2,4,10,40,6,6,1,5,1,9,0,1,"Matches","https://fbref.com/en/comps/9/2021-2022/defense/2021-2022-Premier-League-Stats"
"Jürgen Locadia","Brighton",2022,"nl NED","MF,FW",27,1993,0.3,0,0,0,0,0,0,0,NA,0,0,0,0,0,0,0,0,"Matches","https://fbref.com/en/comps/9/2021-2022/defense/2021-2022-Premier-League-Stats"
"Ruben Loftus-Cheek","Chelsea",2022,"eng ENG","MF,DF",25,1996,15.5,29,10,16,11,2,10,19,52.6,9,15,6,9,11,40,17,0,"Matches","https://fbref.com/en/comps/9/2021-2022/defense/2021-2022-Premier-League-Stats"
"Kevin Long","Burnley",2022,"ie IRL","DF",30,1990,4.6,3,2,1,2,0,1,2,50,1,4,1,3,1,4,20,0,"Matches","https://fbref.com/en/comps/9/2021-2022/defense/2021-2022-Premier-League-Stats"
"Shane Long","Southampton",2022,"ie IRL","FW",34,1987,3.4,9,5,2,4,3,1,1,100,0,4,0,4,0,9,2,0,"Matches","https://fbref.com/en/comps/9/2021-2022/defense/2021-2022-Premier-League-Stats"
"Sean Longstaff","Newcastle Utd",2022,"eng ENG","MF",23,1997,16.3,54,34,18,31,5,24,65,36.9,41,18,6,12,9,63,18,0,"Matches","https://fbref.com/en/comps/9/2021-2022/defense/2021-2022-Premier-League-Stats"
"Ademola Lookman","Leicester City",2022,"ng NGA","FW,MF",23,1997,16.1,32,14,10,13,9,10,28,35.7,18,19,1,18,10,42,4,0,"Matches","https://fbref.com/en/comps/9/2021-2022/defense/2021-2022-Premier-League-Stats"
"Jonas Lössl","Brentford",2022,"dk DEN","GK",32,1989,2,0,0,0,0,0,0,0,NA,0,0,0,0,0,0,1,0,"Matches","https://fbref.com/en/comps/9/2021-2022/defense/2021-2022-Premier-League-Stats"
"Imran Louza","Watford",2022,"ma MAR","MF",22,1999,15.7,41,21,18,20,3,16,38,42.1,22,28,6,22,42,83,20,1,"Matches","https://fbref.com/en/comps/9/2021-2022/defense/2021-2022-Premier-League-Stats"
"Matthew Lowton","Burnley",2022,"eng ENG","DF",32,1989,19.7,38,24,20,10,8,20,37,54.1,17,25,11,14,26,64,68,0,"Matches","https://fbref.com/en/comps/9/2021-2022/defense/2021-2022-Premier-League-Stats"
"Douglas Luiz","Aston Villa",2022,"br BRA","MF",23,1998,30.2,59,39,30,24,5,21,72,29.2,51,30,7,23,34,93,28,1,"Matches","https://fbref.com/en/comps/9/2021-2022/defense/2021-2022-Premier-League-Stats"
"Romelu Lukaku","Chelsea",2022,"be BEL","FW",28,1993,17.7,2,1,0,1,1,1,5,20,4,11,1,10,0,2,20,0,"Matches","https://fbref.com/en/comps/9/2021-2022/defense/2021-2022-Premier-League-Stats"
"Lyanco","Southampton",2022,"br BRA","DF",24,1997,10.1,18,15,11,7,0,10,18,55.6,8,18,13,5,13,31,50,1,"Matches","https://fbref.com/en/comps/9/2021-2022/defense/2021-2022-Premier-League-Stats"
"Alexis Mac Allister","Brighton",2022,"ar ARG","MF,FW",22,1998,23.6,65,40,23,30,12,29,68,42.6,39,37,7,30,13,78,22,0,"Matches","https://fbref.com/en/comps/9/2021-2022/defense/2021-2022-Premier-League-Stats"
"James Maddison","Leicester City",2022,"eng ENG","MF,FW",24,1996,27.3,40,20,8,24,8,14,46,30.4,32,18,3,15,11,51,12,0,"Matches","https://fbref.com/en/comps/9/2021-2022/defense/2021-2022-Premier-League-Stats"
"Harry Maguire","Manchester Utd",2022,"eng ENG","DF",28,1993,27.9,34,21,22,8,4,19,31,61.3,12,36,29,7,32,66,101,3,"Matches","https://fbref.com/en/comps/9/2021-2022/defense/2021-2022-Premier-League-Stats"
"Riyad Mahrez","Manchester City",2022,"dz ALG","FW",30,1991,16.6,11,3,5,4,2,5,19,26.3,14,15,1,14,6,17,6,0,"Matches","https://fbref.com/en/comps/9/2021-2022/defense/2021-2022-Premier-League-Stats"
"Ainsley Maitland-Niles","Arsenal",2022,"eng ENG","MF",23,1997,3,8,4,5,3,0,2,4,50,2,2,0,2,4,12,4,0,"Matches","https://fbref.com/en/comps/9/2021-2022/defense/2021-2022-Premier-League-Stats"
"Sadio Mané","Liverpool",2022,"sn SEN","FW",29,1992,31.3,33,20,7,14,12,8,26,30.8,18,30,1,29,8,41,15,0,"Matches","https://fbref.com/en/comps/9/2021-2022/defense/2021-2022-Premier-League-Stats"
"Javier Manquillo","Newcastle Utd",2022,"es ESP","DF",27,1994,14,39,29,28,10,1,21,36,58.3,15,15,6,9,10,49,32,0,"Matches","https://fbref.com/en/comps/9/2021-2022/defense/2021-2022-Premier-League-Stats"
"Fernando Marçal","Wolves",2022,"br BRA","MF,DF",32,1989,16.1,42,22,27,14,1,21,37,56.8,16,25,4,21,28,70,52,0,"Matches","https://fbref.com/en/comps/9/2021-2022/defense/2021-2022-Premier-League-Stats"
"Solly March","Brighton",2022,"eng ENG","DF,FW",27,1994,19.4,30,17,11,9,10,7,22,31.8,15,22,3,19,17,47,25,0,"Matches","https://fbref.com/en/comps/9/2021-2022/defense/2021-2022-Premier-League-Stats"
"Pablo Marí","Arsenal",2022,"es ESP","DF",27,1993,2,5,3,1,3,1,3,6,50,3,5,4,1,3,8,10,0,"Matches","https://fbref.com/en/comps/9/2021-2022/defense/2021-2022-Premier-League-Stats"
"Anthony Martial","Manchester Utd",2022,"fr FRA","FW",25,1995,2.4,0,0,0,0,0,0,1,0,1,1,0,1,0,0,1,0,"Matches","https://fbref.com/en/comps/9/2021-2022/defense/2021-2022-Premier-League-Stats"
"Martinelli","Arsenal",2022,"br BRA","FW,MF",20,2001,20.7,27,19,7,14,6,10,29,34.5,19,26,1,25,20,47,15,0,"Matches","https://fbref.com/en/comps/9/2021-2022/defense/2021-2022-Premier-League-Stats"
"Emiliano Martínez","Aston Villa",2022,"ar ARG","GK",28,1992,36,1,1,1,0,0,1,3,33.3,2,0,0,0,0,1,6,1,"Matches","https://fbref.com/en/comps/9/2021-2022/defense/2021-2022-Premier-League-Stats"
"Adam Masina","Watford",2022,"ma MAR","DF",27,1994,12,24,13,11,10,3,12,29,41.4,17,18,6,12,18,42,45,0,"Matches","https://fbref.com/en/comps/9/2021-2022/defense/2021-2022-Premier-League-Stats"
"Arthur Masuaku","West Ham",2022,"cd COD","DF,FW",27,1993,7.2,31,23,19,11,1,14,23,60.9,9,9,1,8,9,40,17,0,"Matches","https://fbref.com/en/comps/9/2021-2022/defense/2021-2022-Premier-League-Stats"
"Juan Mata","Manchester Utd",2022,"es ESP","MF",33,1988,2.6,6,4,2,3,1,3,5,60,2,1,0,1,1,7,1,0,"Matches","https://fbref.com/en/comps/9/2021-2022/defense/2021-2022-Premier-League-Stats"
"Jean-Philippe Mateta","Crystal Palace",2022,"fr FRA","FW",24,1997,12.7,8,4,2,5,1,3,18,16.7,15,11,3,8,4,12,13,0,"Matches","https://fbref.com/en/comps/9/2021-2022/defense/2021-2022-Premier-League-Stats"
"Nemanja Matic","Manchester Utd",2022,"rs SRB","MF",32,1988,15.4,31,18,19,11,1,15,31,48.4,16,21,6,15,31,62,21,3,"Matches","https://fbref.com/en/comps/9/2021-2022/defense/2021-2022-Premier-League-Stats"
"Joël Matip","Liverpool",2022,"cm CMR","DF",29,1991,31,47,34,23,19,5,20,31,64.5,11,26,14,12,44,91,93,1,"Matches","https://fbref.com/en/comps/9/2021-2022/defense/2021-2022-Premier-League-Stats"
"Neal Maupay","Brighton",2022,"fr FRA","FW",24,1996,25.3,17,10,2,6,9,4,18,22.2,14,21,2,19,2,19,2,0,"Matches","https://fbref.com/en/comps/9/2021-2022/defense/2021-2022-Premier-League-Stats"
"Bryan Mbeumo","Brentford",2022,"cm CMR","FW",21,1999,32.3,28,16,1,12,15,6,20,30,14,21,6,15,11,39,20,0,"Matches","https://fbref.com/en/comps/9/2021-2022/defense/2021-2022-Premier-League-Stats"
"James McArthur","Crystal Palace",2022,"sct SCO","MF",33,1987,16,33,23,13,19,1,16,44,36.4,28,23,9,14,30,63,27,0,"Matches","https://fbref.com/en/comps/9/2021-2022/defense/2021-2022-Premier-League-Stats"
"James Mcatee","Manchester City",2022,"eng ENG","MF,FW",18,2002,0.2,0,0,0,0,0,0,2,0,2,0,0,0,0,0,0,0,"Matches","https://fbref.com/en/comps/9/2021-2022/defense/2021-2022-Premier-League-Stats"
"Kasey McAteer","Leicester City",2022,"eng ENG","FW",19,2001,0,0,0,0,0,0,0,0,NA,0,0,0,0,0,0,0,0,"Matches","https://fbref.com/en/comps/9/2021-2022/defense/2021-2022-Premier-League-Stats"
"Liam McCarron","Leeds United",2022,"sct SCO","FW",20,2001,0.1,0,0,0,0,0,0,0,NA,0,1,0,1,0,0,0,0,"Matches","https://fbref.com/en/comps/9/2021-2022/defense/2021-2022-Premier-League-Stats"
"Alex McCarthy","Southampton",2022,"eng ENG","GK",31,1989,17,0,0,0,0,0,0,0,NA,0,0,0,0,0,0,4,0,"Matches","https://fbref.com/en/comps/9/2021-2022/defense/2021-2022-Premier-League-Stats"
"John McGinn","Aston Villa",2022,"sct SCO","MF",26,1994,34.3,106,64,35,55,16,54,104,51.9,50,53,6,47,35,141,34,0,"Matches","https://fbref.com/en/comps/9/2021-2022/defense/2021-2022-Premier-League-Stats"
"Stuart McKinstry","Leeds United",2022,"sct SCO","MF",18,2002,0,0,0,0,0,0,0,0,NA,0,0,0,0,0,0,0,0,"Matches","https://fbref.com/en/comps/9/2021-2022/defense/2021-2022-Premier-League-Stats"
"Kenny McLean","Norwich City",2022,"sct SCO","MF",29,1992,30.1,42,22,18,20,4,17,59,28.8,42,29,7,22,34,76,54,0,"Matches","https://fbref.com/en/comps/9/2021-2022/defense/2021-2022-Premier-League-Stats"
"Dwight McNeil","Burnley",2022,"eng ENG","MF",21,1999,34.5,78,49,27,38,13,33,73,45.2,40,64,11,53,35,113,31,1,"Matches","https://fbref.com/en/comps/9/2021-2022/defense/2021-2022-Premier-League-Stats"
"Scott McTominay","Manchester Utd",2022,"sct SCO","MF",24,1996,26.5,65,33,32,24,9,30,61,49.2,31,45,10,35,31,96,60,1,"Matches","https://fbref.com/en/comps/9/2021-2022/defense/2021-2022-Premier-League-Stats"
"Ben Mee","Burnley",2022,"eng ENG","DF",31,1989,20.4,26,12,16,7,3,12,19,63.2,7,28,22,6,24,50,94,1,"Matches","https://fbref.com/en/comps/9/2021-2022/defense/2021-2022-Premier-League-Stats"
"Hannibal Mejbri","Manchester Utd",2022,"tn TUN","FW",18,2003,0.8,2,1,1,1,0,1,1,100,0,0,0,0,0,2,0,0,"Matches","https://fbref.com/en/comps/9/2021-2022/defense/2021-2022-Premier-League-Stats"
"Benjamin Mendy","Manchester City",2022,"fr FRA","DF",27,1994,0.9,2,2,1,1,0,2,6,33.3,4,0,0,0,0,2,0,0,"Matches","https://fbref.com/en/comps/9/2021-2022/defense/2021-2022-Premier-League-Stats"
"Edouard Mendy","Chelsea",2022,"sn SEN","GK",29,1992,34,1,0,1,0,0,1,3,33.3,2,0,0,0,0,1,13,4,"Matches","https://fbref.com/en/comps/9/2021-2022/defense/2021-2022-Premier-League-Stats"
"Nampalys Mendy","Leicester City",2022,"sn SEN","MF",29,1992,11.5,12,6,8,4,0,6,17,35.3,11,7,4,3,11,23,11,1,"Matches","https://fbref.com/en/comps/9/2021-2022/defense/2021-2022-Premier-League-Stats"
"Illan Meslier","Leeds United",2022,"fr FRA","GK",21,2000,37.6,1,1,1,0,0,1,1,100,0,0,0,0,0,1,27,1,"Matches","https://fbref.com/en/comps/9/2021-2022/defense/2021-2022-Premier-League-Stats"
"Luka Milivojevic","Crystal Palace",2022,"rs SRB","MF",30,1991,8.6,18,9,9,6,3,10,16,62.5,6,6,1,5,11,29,15,0,"Matches","https://fbref.com/en/comps/9/2021-2022/defense/2021-2022-Premier-League-Stats"
"James Milner","Liverpool",2022,"eng ENG","MF,DF",35,1986,9.5,28,16,12,11,5,12,29,41.4,17,19,5,14,17,45,20,0,"Matches","https://fbref.com/en/comps/9/2021-2022/defense/2021-2022-Premier-League-Stats"
"Yerry Mina","Everton",2022,"co COL","DF",26,1994,9.4,12,10,12,0,0,10,13,76.9,3,13,9,4,11,23,38,1,"Matches","https://fbref.com/en/comps/9/2021-2022/defense/2021-2022-Premier-League-Stats"
"Takumi Minamino","Liverpool",2022,"jp JPN","FW,MF",26,1995,2.1,3,2,1,1,1,2,8,25,6,2,0,2,1,4,2,0,"Matches","https://fbref.com/en/comps/9/2021-2022/defense/2021-2022-Premier-League-Stats"
"Tyrone Mings","Aston Villa",2022,"eng ENG","DF",28,1993,35.4,23,12,17,3,3,14,22,63.6,8,47,30,17,46,69,153,2,"Matches","https://fbref.com/en/comps/9/2021-2022/defense/2021-2022-Premier-League-Stats"
"Tyrick Mitchell","Crystal Palace",2022,"eng ENG","DF",21,1999,34.5,104,57,67,26,11,46,67,68.7,21,47,5,42,41,145,101,0,"Matches","https://fbref.com/en/comps/9/2021-2022/defense/2021-2022-Premier-League-Stats"
"Jakub Moder","Brighton",2022,"pl POL","MF",22,1999,18.9,42,25,18,17,7,23,42,54.8,19,25,2,23,10,52,22,1,"Matches","https://fbref.com/en/comps/9/2021-2022/defense/2021-2022-Premier-League-Stats"
"Wesley Moraes","Aston Villa",2022,"br BRA","FW",24,1996,0,0,0,0,0,0,0,0,NA,0,0,0,0,0,0,0,0,"Matches","https://fbref.com/en/comps/9/2021-2022/defense/2021-2022-Premier-League-Stats"
"Tyler Morton","Liverpool",2022,"eng ENG","MF",18,2002,0.7,0,0,0,0,0,0,2,0,2,0,0,0,3,3,0,0,"Matches","https://fbref.com/en/comps/9/2021-2022/defense/2021-2022-Premier-League-Stats"
"Mason Mount","Chelsea",2022,"eng ENG","MF",22,1999,26.3,41,16,10,17,14,10,34,29.4,24,18,1,17,13,54,12,0,"Matches","https://fbref.com/en/comps/9/2021-2022/defense/2021-2022-Premier-League-Stats"
"Lucas Moura","Tottenham",2022,"br BRA","FW,MF",28,1992,19.7,25,10,7,14,4,8,35,22.9,27,19,0,19,18,43,19,0,"Matches","https://fbref.com/en/comps/9/2021-2022/defense/2021-2022-Premier-League-Stats"
"João Moutinho","Wolves",2022,"pt POR","MF",34,1986,33,74,39,34,27,13,30,106,28.3,76,48,8,40,34,108,36,2,"Matches","https://fbref.com/en/comps/9/2021-2022/defense/2021-2022-Premier-League-Stats"
"Bali Mumba","Norwich City",2022,"eng ENG","DF",19,2001,0.5,1,1,1,0,0,0,0,NA,0,0,0,0,0,1,5,0,"Matches","https://fbref.com/en/comps/9/2021-2022/defense/2021-2022-Premier-League-Stats"
"Jacob Murphy","Newcastle Utd",2022,"eng ENG","FW,DF",26,1995,16.4,49,26,34,11,4,26,41,63.4,15,20,2,18,23,72,17,0,"Matches","https://fbref.com/en/comps/9/2021-2022/defense/2021-2022-Premier-League-Stats"
"Enock Mwepu","Brighton",2022,"zm ZAM","MF",23,1998,11.1,22,12,10,10,2,5,27,18.5,22,20,2,18,12,34,19,0,"Matches","https://fbref.com/en/comps/9/2021-2022/defense/2021-2022-Premier-League-Stats"
"Vitaliy Mykolenko","Everton",2022,"ua UKR","DF",22,1999,11.7,25,15,15,7,3,12,21,57.1,9,15,2,13,16,41,37,0,"Matches","https://fbref.com/en/comps/9/2021-2022/defense/2021-2022-Premier-League-Stats"
"Marvelous Nakamba","Aston Villa",2022,"zw ZIM","MF",27,1994,10,32,19,18,14,0,12,34,35.3,22,14,4,10,12,44,17,1,"Matches","https://fbref.com/en/comps/9/2021-2022/defense/2021-2022-Premier-League-Stats"
"Wilfred Ndidi","Leicester City",2022,"ng NGA","MF,DF",24,1996,18,60,32,32,27,1,22,55,40,33,36,8,28,42,102,54,1,"Matches","https://fbref.com/en/comps/9/2021-2022/defense/2021-2022-Premier-League-Stats"
"Tanguy Ndombele","Tottenham",2022,"fr FRA","MF",24,1996,5.4,10,7,3,5,2,1,8,12.5,7,5,0,5,1,11,1,0,"Matches","https://fbref.com/en/comps/9/2021-2022/defense/2021-2022-Premier-League-Stats"
"Reiss Nelson","Arsenal",2022,"eng ENG","FW",21,1999,0.2,1,0,0,0,1,0,1,0,1,1,0,1,0,1,0,0,"Matches","https://fbref.com/en/comps/9/2021-2022/defense/2021-2022-Premier-League-Stats"
"Pedro Neto","Wolves",2022,"pt POR","FW,MF",21,2000,5.2,4,4,2,0,2,0,9,0,9,0,0,0,6,10,1,0,"Matches","https://fbref.com/en/comps/9/2021-2022/defense/2021-2022-Premier-League-Stats"
"Rúben Neves","Wolves",2022,"pt POR","MF",24,1997,29.6,68,37,23,41,4,24,87,27.6,63,39,5,34,41,109,49,3,"Matches","https://fbref.com/en/comps/9/2021-2022/defense/2021-2022-Premier-League-Stats"
"Jeremy Ngakia","Watford",2022,"eng ENG","DF",20,2000,10,31,18,23,5,3,11,26,42.3,15,11,4,7,12,43,32,0,"Matches","https://fbref.com/en/comps/9/2021-2022/defense/2021-2022-Premier-League-Stats"
"Saúl Ñíguez","Chelsea",2022,"es ESP","DF,MF",26,1994,5.3,20,9,11,9,0,9,16,56.3,7,14,3,11,7,27,10,1,"Matches","https://fbref.com/en/comps/9/2021-2022/defense/2021-2022-Premier-League-Stats"
"Eddie Nketiah","Arsenal",2022,"eng ENG","FW",22,1999,9.3,9,4,1,4,4,1,4,25,3,9,2,7,4,13,5,0,"Matches","https://fbref.com/en/comps/9/2021-2022/defense/2021-2022-Premier-League-Stats"
"Nicolas Nkoulou","Watford",2022,"cm CMR","DF",31,1990,1.9,1,0,0,1,0,0,0,NA,0,2,1,1,2,3,8,0,"Matches","https://fbref.com/en/comps/9/2021-2022/defense/2021-2022-Premier-League-Stats"
"Mark Noble","West Ham",2022,"eng ENG","MF",34,1987,3.7,8,2,7,1,0,5,11,45.5,6,4,1,3,4,12,2,1,"Matches","https://fbref.com/en/comps/9/2021-2022/defense/2021-2022-Premier-League-Stats"
"Mathias Normann","Norwich City",2022,"no NOR","MF",25,1996,18.3,34,21,19,14,1,17,46,37,29,17,8,9,19,53,43,1,"Matches","https://fbref.com/en/comps/9/2021-2022/defense/2021-2022-Premier-League-Stats"
"Christian Nørgaard","Brentford",2022,"dk DEN","MF",27,1994,33.9,109,60,42,58,9,52,101,51.5,49,48,9,39,64,173,58,1,"Matches","https://fbref.com/en/comps/9/2021-2022/defense/2021-2022-Premier-League-Stats"
"Angelo Ogbonna","West Ham",2022,"it ITA","DF",33,1988,10.2,7,4,5,2,0,3,7,42.9,4,5,4,1,11,18,29,0,"Matches","https://fbref.com/en/comps/9/2021-2022/defense/2021-2022-Premier-League-Stats"
"Michael Olise","Crystal Palace",2022,"fr FRA","FW,MF",19,2001,12.7,22,18,8,11,3,7,24,29.2,17,17,0,17,6,28,6,0,"Matches","https://fbref.com/en/comps/9/2021-2022/defense/2021-2022-Premier-League-Stats"
"Robin Olsen","Aston Villa",2022,"se SWE","GK",31,1990,1,0,0,0,0,0,0,0,NA,0,0,0,0,0,0,0,0,"Matches","https://fbref.com/en/comps/9/2021-2022/defense/2021-2022-Premier-League-Stats"
"Andrew Omobamidele","Norwich City",2022,"ie IRL","DF",19,2002,4.2,8,6,5,3,0,5,11,45.5,6,8,8,0,5,13,13,0,"Matches","https://fbref.com/en/comps/9/2021-2022/defense/2021-2022-Premier-League-Stats"
"Tyler Onyango","Everton",2022,"eng ENG","MF",18,2003,0.3,0,0,0,0,0,0,0,NA,0,0,0,0,0,0,1,0,"Matches","https://fbref.com/en/comps/9/2021-2022/defense/2021-2022-Premier-League-Stats"
"Frank Onyeka","Brentford",2022,"ng NGA","MF",23,1998,11.6,25,17,13,9,3,8,27,29.6,19,16,2,14,14,39,13,0,"Matches","https://fbref.com/en/comps/9/2021-2022/defense/2021-2022-Premier-League-Stats"
"Divock Origi","Liverpool",2022,"be BEL","FW",26,1995,1.5,0,0,0,0,0,0,2,0,2,1,0,1,1,1,2,0,"Matches","https://fbref.com/en/comps/9/2021-2022/defense/2021-2022-Premier-League-Stats"
"Alex Oxlade-Chamberlain","Liverpool",2022,"eng ENG","MF,FW",27,1993,8.7,15,11,2,8,5,3,14,21.4,11,12,2,10,6,21,5,0,"Matches","https://fbref.com/en/comps/9/2021-2022/defense/2021-2022-Premier-League-Stats"
"Cole Palmer","Manchester City",2022,"eng ENG","FW,MF",19,2002,1.4,2,1,1,1,0,0,2,0,2,3,0,3,1,3,0,0,"Matches","https://fbref.com/en/comps/9/2021-2022/defense/2021-2022-Premier-League-Stats"
"Emerson Palmieri","Chelsea",2022,"it ITA","DF",26,1994,0.1,0,0,0,0,0,0,0,NA,0,0,0,0,0,0,0,0,"Matches","https://fbref.com/en/comps/9/2021-2022/defense/2021-2022-Premier-League-Stats"
"Thomas Partey","Arsenal",2022,"gh GHA","MF",28,1993,22.5,43,29,22,17,4,18,44,40.9,26,22,4,18,23,66,35,2,"Matches","https://fbref.com/en/comps/9/2021-2022/defense/2021-2022-Premier-League-Stats"
"Nicolas Pépé","Arsenal",2022,"ci CIV","FW,MF",26,1995,7.7,8,5,3,5,0,3,9,33.3,6,9,1,8,8,16,2,0,"Matches","https://fbref.com/en/comps/9/2021-2022/defense/2021-2022-Premier-League-Stats"
"Ricardo Pereira","Leicester City",2022,"pt POR","DF",27,1993,11,37,20,19,13,5,21,40,52.5,19,13,1,12,17,54,39,0,"Matches","https://fbref.com/en/comps/9/2021-2022/defense/2021-2022-Premier-League-Stats"
"Ayoze Pérez","Leicester City",2022,"es ESP","MF,FW",28,1993,4.9,4,2,0,3,1,0,13,0,13,11,1,10,2,6,5,0,"Matches","https://fbref.com/en/comps/9/2021-2022/defense/2021-2022-Premier-League-Stats"
"Sonny Perkins","West Ham",2022,"eng ENG","FW",17,2004,0,NA,0,NA,NA,NA,NA,NA,NA,NA,NA,NA,NA,0,NA,NA,NA,"Matches","https://fbref.com/en/comps/9/2021-2022/defense/2021-2022-Premier-League-Stats"
"Romain Perraud","Southampton",2022,"fr FRA","DF",23,1997,18,34,22,18,14,2,16,29,55.2,13,24,6,18,17,51,42,0,"Matches","https://fbref.com/en/comps/9/2021-2022/defense/2021-2022-Premier-League-Stats"
"Kalvin Phillips","Leeds United",2022,"eng ENG","MF",25,1995,17.7,54,25,24,25,5,24,57,42.1,33,37,9,28,24,78,18,0,"Matches","https://fbref.com/en/comps/9/2021-2022/defense/2021-2022-Premier-League-Stats"
"Jaden Philogene Bidace","Aston Villa",2022,"eng ENG","FW",19,2002,0.1,0,0,0,0,0,0,0,NA,0,0,0,0,0,0,0,0,"Matches","https://fbref.com/en/comps/9/2021-2022/defense/2021-2022-Premier-League-Stats"
"Jordan Pickford","Everton",2022,"eng ENG","GK",27,1994,35,1,1,1,0,0,0,1,0,1,1,0,1,1,2,14,1,"Matches","https://fbref.com/en/comps/9/2021-2022/defense/2021-2022-Premier-League-Stats"
"Erik Pieters","Burnley",2022,"nl NED","DF",32,1988,8.1,28,15,15,11,2,17,28,60.7,11,18,7,11,10,38,38,0,"Matches","https://fbref.com/en/comps/9/2021-2022/defense/2021-2022-Premier-League-Stats"
"Ethan Pinnock","Brentford",2022,"jm JAM","DF",28,1993,29.9,51,35,37,12,2,25,38,65.8,13,30,11,19,44,95,154,1,"Matches","https://fbref.com/en/comps/9/2021-2022/defense/2021-2022-Premier-League-Stats"
"Daniel Podence","Wolves",2022,"pt POR","FW,MF",25,1995,16.5,18,11,10,5,3,4,17,23.5,13,8,1,7,10,28,1,0,"Matches","https://fbref.com/en/comps/9/2021-2022/defense/2021-2022-Premier-League-Stats"
"Paul Pogba","Manchester Utd",2022,"fr FRA","MF,FW",28,1993,15,13,9,5,7,1,6,28,21.4,22,11,0,11,13,26,16,0,"Matches","https://fbref.com/en/comps/9/2021-2022/defense/2021-2022-Premier-League-Stats"
"Nick Pope","Burnley",2022,"eng ENG","GK",29,1992,36,0,0,0,0,0,0,2,0,2,0,0,0,2,2,30,3,"Matches","https://fbref.com/en/comps/9/2021-2022/defense/2021-2022-Premier-League-Stats"
"Isaac Price","Everton",2022,"nir NIR","MF",17,2003,0.2,0,0,0,0,0,0,0,NA,0,1,0,1,0,0,0,0,"Matches","https://fbref.com/en/comps/9/2021-2022/defense/2021-2022-Premier-League-Stats"
"Teemu Pukki","Norwich City",2022,"fi FIN","FW",31,1990,36.1,23,11,2,14,7,6,29,20.7,23,21,1,20,4,27,3,0,"Matches","https://fbref.com/en/comps/9/2021-2022/defense/2021-2022-Premier-League-Stats"
"Christian Pulisic","Chelsea",2022,"us USA","MF,FW",22,1998,14.3,10,7,6,3,1,3,17,17.6,14,12,0,12,5,15,10,0,"Matches","https://fbref.com/en/comps/9/2021-2022/defense/2021-2022-Premier-League-Stats"
"Przemyslaw Placheta","Norwich City",2022,"pl POL","FW,MF",23,1998,5.6,4,3,3,1,0,2,7,28.6,5,3,1,2,2,6,5,1,"Matches","https://fbref.com/en/comps/9/2021-2022/defense/2021-2022-Premier-League-Stats"
"Jesuran Rak Sakyi","Crystal Palace",2022,"eng ENG","FW,MF",18,2002,0.9,0,0,0,0,0,0,1,0,1,3,0,3,1,1,0,0,"Matches","https://fbref.com/en/comps/9/2021-2022/defense/2021-2022-Premier-League-Stats"
"Aaron Ramsdale","Arsenal",2022,"eng ENG","GK",23,1998,34,2,1,2,0,0,1,2,50,1,0,0,0,0,2,26,3,"Matches","https://fbref.com/en/comps/9/2021-2022/defense/2021-2022-Premier-League-Stats"
"Jacob Ramsey","Aston Villa",2022,"eng ENG","MF",20,2001,27.4,67,44,31,28,8,30,69,43.5,39,36,7,29,24,91,28,0,"Matches","https://fbref.com/en/comps/9/2021-2022/defense/2021-2022-Premier-League-Stats"
"Raphinha","Leeds United",2022,"br BRA","FW,MF",24,1996,32.4,51,29,25,14,12,22,71,31,49,43,0,43,29,80,28,1,"Matches","https://fbref.com/en/comps/9/2021-2022/defense/2021-2022-Premier-League-Stats"
"Marcus Rashford","Manchester Utd",2022,"eng ENG","FW,MF",23,1997,13.7,6,5,1,4,1,2,13,15.4,11,10,1,9,5,11,5,1,"Matches","https://fbref.com/en/comps/9/2021-2022/defense/2021-2022-Premier-League-Stats"
"Milot Rashica","Norwich City",2022,"xk KVX","FW,MF",25,1996,24.8,31,19,12,12,7,11,30,36.7,19,22,3,19,15,46,23,0,"Matches","https://fbref.com/en/comps/9/2021-2022/defense/2021-2022-Premier-League-Stats"
"David Raya","Brentford",2022,"es ESP","GK",25,1995,24,0,0,0,0,0,0,0,NA,0,1,0,1,0,0,10,1,"Matches","https://fbref.com/en/comps/9/2021-2022/defense/2021-2022-Premier-League-Stats"
"Nathan Redmond","Southampton",2022,"eng ENG","MF,FW",27,1994,20.4,22,14,9,9,4,7,30,23.3,23,21,2,19,8,30,16,0,"Matches","https://fbref.com/en/comps/9/2021-2022/defense/2021-2022-Premier-League-Stats"
"Sergio Reguilón","Tottenham",2022,"es ESP","DF,MF",24,1996,21.3,40,24,15,18,7,22,43,51.2,21,20,8,12,31,71,45,1,"Matches","https://fbref.com/en/comps/9/2021-2022/defense/2021-2022-Premier-League-Stats"
"Declan Rice","West Ham",2022,"eng ENG","MF",22,1999,35.3,80,42,45,32,3,38,71,53.5,33,45,21,24,63,143,52,1,"Matches","https://fbref.com/en/comps/9/2021-2022/defense/2021-2022-Premier-League-Stats"
"Taylor Richards","Brighton",2022,"eng ENG","MF",20,2000,0.3,1,0,0,1,0,1,2,50,1,0,0,0,0,1,0,0,"Matches","https://fbref.com/en/comps/9/2021-2022/defense/2021-2022-Premier-League-Stats"
"Richarlison","Everton",2022,"br BRA","FW",24,1997,28,40,23,18,15,7,15,31,48.4,16,42,4,38,12,52,34,0,"Matches","https://fbref.com/en/comps/9/2021-2022/defense/2021-2022-Premier-League-Stats"
"Jaïro Riedewald","Crystal Palace",2022,"nl NED","MF",24,1996,1.3,1,1,0,1,0,1,2,50,1,1,0,1,1,2,2,0,"Matches","https://fbref.com/en/comps/9/2021-2022/defense/2021-2022-Premier-League-Stats"
"Matt Ritchie","Newcastle Utd",2022,"sct SCO","DF",31,1989,14.9,22,15,10,10,2,10,27,37,17,10,2,8,13,35,26,0,"Matches","https://fbref.com/en/comps/9/2021-2022/defense/2021-2022-Premier-League-Stats"
"Connor Roberts","Burnley",2022,"wls WAL","DF",25,1995,18.8,20,13,10,7,3,10,15,66.7,5,25,5,20,22,42,62,1,"Matches","https://fbref.com/en/comps/9/2021-2022/defense/2021-2022-Premier-League-Stats"
"Tyler Roberts","Leeds United",2022,"wls WAL","MF,FW",22,1999,11,16,7,6,7,3,9,16,56.3,7,11,1,10,5,21,11,0,"Matches","https://fbref.com/en/comps/9/2021-2022/defense/2021-2022-Premier-League-Stats"
"Andrew Robertson","Liverpool",2022,"sct SCO","DF",27,1994,28.2,36,21,16,15,5,20,35,57.1,15,24,3,21,23,59,61,0,"Matches","https://fbref.com/en/comps/9/2021-2022/defense/2021-2022-Premier-League-Stats"
"Joe Rodon","Tottenham",2022,"wls WAL","DF",23,1997,1,0,0,0,0,0,0,0,NA,0,2,1,1,0,0,7,0,"Matches","https://fbref.com/en/comps/9/2021-2022/defense/2021-2022-Premier-League-Stats"
"Rodri","Manchester City",2022,"es ESP","MF",25,1996,32,72,43,24,38,10,32,59,54.2,27,28,5,23,28,100,45,0,"Matches","https://fbref.com/en/comps/9/2021-2022/defense/2021-2022-Premier-League-Stats"
"Rodrigo","Leeds United",2022,"es ESP","MF,FW",30,1991,25.2,20,9,7,6,7,4,32,12.5,28,12,0,12,11,31,27,1,"Matches","https://fbref.com/en/comps/9/2021-2022/defense/2021-2022-Premier-League-Stats"
"Jay Rodriguez","Burnley",2022,"eng ENG","FW",32,1989,15.4,20,12,8,8,4,4,14,28.6,10,19,1,18,4,24,12,0,"Matches","https://fbref.com/en/comps/9/2021-2022/defense/2021-2022-Premier-League-Stats"
"Mads Roerslev","Brentford",2022,"dk DEN","DF",22,1999,13.8,23,12,19,2,2,14,32,43.8,18,14,5,9,16,39,29,0,"Matches","https://fbref.com/en/comps/9/2021-2022/defense/2021-2022-Premier-League-Stats"
"Cristian Romero","Tottenham",2022,"ar ARG","DF",23,1998,20.5,62,39,39,21,2,22,34,64.7,12,46,21,25,33,95,74,1,"Matches","https://fbref.com/en/comps/9/2021-2022/defense/2021-2022-Premier-League-Stats"
"Oriol Romeu","Southampton",2022,"es ESP","MF",29,1991,32.1,77,39,25,45,7,28,73,38.4,45,39,8,31,51,128,43,0,"Matches","https://fbref.com/en/comps/9/2021-2022/defense/2021-2022-Premier-League-Stats"
"Cristiano Ronaldo","Manchester Utd",2022,"pt POR","FW",36,1985,27.3,8,6,1,5,2,2,6,33.3,4,8,0,8,2,10,29,0,"Matches","https://fbref.com/en/comps/9/2021-2022/defense/2021-2022-Premier-League-Stats"
"Salomón Rondón","Everton",2022,"ve VEN","FW",31,1989,8.8,6,1,1,2,3,4,14,28.6,10,5,0,5,0,6,10,0,"Matches","https://fbref.com/en/comps/9/2021-2022/defense/2021-2022-Premier-League-Stats"
"Danny Rose","Watford",2022,"eng ENG","DF",31,1990,7.7,16,10,11,4,1,10,24,41.7,14,8,5,3,14,30,11,1,"Matches","https://fbref.com/en/comps/9/2021-2022/defense/2021-2022-Premier-League-Stats"
"Jon Rowe","Norwich City",2022,"eng ENG","FW,MF",18,2003,2.5,3,2,2,1,0,2,3,66.7,1,7,0,7,3,6,1,0,"Matches","https://fbref.com/en/comps/9/2021-2022/defense/2021-2022-Premier-League-Stats"
"John Ruddy","Wolves",2022,"eng ENG","GK",34,1986,1.5,0,0,0,0,0,0,0,NA,0,0,0,0,0,0,3,0,"Matches","https://fbref.com/en/comps/9/2021-2022/defense/2021-2022-Premier-League-Stats"
"Antonio Rüdiger","Chelsea",2022,"de GER","DF",28,1993,33.7,48,28,29,15,4,36,48,75,12,20,11,9,28,76,91,1,"Matches","https://fbref.com/en/comps/9/2021-2022/defense/2021-2022-Premier-League-Stats"
"Lukas Rupp","Norwich City",2022,"de GER","MF",30,1991,8.5,9,4,5,3,1,4,15,26.7,11,11,1,10,9,18,7,0,"Matches","https://fbref.com/en/comps/9/2021-2022/defense/2021-2022-Premier-League-Stats"
"José Sá","Wolves",2022,"pt POR","GK",28,1993,36.5,2,1,2,0,0,2,4,50,2,0,0,0,2,4,19,5,"Matches","https://fbref.com/en/comps/9/2021-2022/defense/2021-2022-Premier-League-Stats"
"Allan Saint-Maximin","Newcastle Utd",2022,"fr FRA","FW,MF",24,1997,31.2,13,8,6,4,3,3,17,17.6,14,13,2,11,11,24,3,0,"Matches","https://fbref.com/en/comps/9/2021-2022/defense/2021-2022-Premier-League-Stats"
"Romain Saïss","Wolves",2022,"ma MAR","DF",31,1990,30.1,40,27,28,11,1,19,33,57.6,14,41,21,20,58,98,158,2,"Matches","https://fbref.com/en/comps/9/2021-2022/defense/2021-2022-Premier-League-Stats"
"Bukayo Saka","Arsenal",2022,"eng ENG","FW,MF",19,2001,33.1,40,21,12,17,11,13,39,33.3,26,28,2,26,22,62,23,0,"Matches","https://fbref.com/en/comps/9/2021-2022/defense/2021-2022-Premier-League-Stats"
"Mohamed Salah","Liverpool",2022,"eg EGY","FW",29,1992,30.7,17,8,5,9,3,6,19,31.6,13,7,1,6,6,23,5,0,"Matches","https://fbref.com/en/comps/9/2021-2022/defense/2021-2022-Premier-League-Stats"
"Mohammed Salisu","Southampton",2022,"gh GHA","DF",22,1999,33,80,47,54,22,4,40,65,61.5,25,49,26,23,78,158,158,4,"Matches","https://fbref.com/en/comps/9/2021-2022/defense/2021-2022-Premier-League-Stats"
"Albert Sambi Lokonga","Arsenal",2022,"be BEL","MF",21,1999,12.6,22,18,11,9,2,12,14,85.7,2,12,7,5,13,35,12,4,"Matches","https://fbref.com/en/comps/9/2021-2022/defense/2021-2022-Premier-League-Stats"
"Davinson Sánchez","Tottenham",2022,"co COL","DF",25,1996,18.1,41,22,25,14,2,19,28,67.9,9,24,16,8,30,71,54,3,"Matches","https://fbref.com/en/comps/9/2021-2022/defense/2021-2022-Premier-League-Stats"
"Robert Sánchez","Brighton",2022,"es ESP","GK",23,1997,37,2,1,2,0,0,1,1,100,0,1,0,1,0,2,11,4,"Matches","https://fbref.com/en/comps/9/2021-2022/defense/2021-2022-Premier-League-Stats"
"Jadon Sancho","Manchester Utd",2022,"eng ENG","FW,MF",21,2000,21.1,14,8,9,4,1,8,22,36.4,14,19,0,19,15,29,5,3,"Matches","https://fbref.com/en/comps/9/2021-2022/defense/2021-2022-Premier-League-Stats"
"Morgan Sanson","Aston Villa",2022,"fr FRA","MF",26,1994,4,12,8,7,2,3,3,7,42.9,4,13,0,13,10,22,2,1,"Matches","https://fbref.com/en/comps/9/2021-2022/defense/2021-2022-Premier-League-Stats"
"Samir Santos","Watford",2022,"br BRA","DF",26,1994,18.6,24,11,18,6,0,8,19,42.1,11,21,11,10,43,67,85,3,"Matches","https://fbref.com/en/comps/9/2021-2022/defense/2021-2022-Premier-League-Stats"
"Josh Sargent","Norwich City",2022,"us USA","FW,MF",21,2000,17.5,26,14,15,7,4,14,39,35.9,25,29,2,27,11,37,18,2,"Matches","https://fbref.com/en/comps/9/2021-2022/defense/2021-2022-Premier-League-Stats"
"Jeremy Sarmiento","Brighton",2022,"ec ECU","FW,MF",19,2002,0.5,1,1,0,0,1,0,2,0,2,2,0,2,0,1,0,0,"Matches","https://fbref.com/en/comps/9/2021-2022/defense/2021-2022-Premier-League-Stats"
"Ismaila Sarr","Watford",2022,"sn SEN","FW,MF",23,1998,20.7,12,7,4,3,5,5,19,26.3,14,10,1,9,9,21,10,0,"Matches","https://fbref.com/en/comps/9/2021-2022/defense/2021-2022-Premier-League-Stats"
"Malang Sarr","Chelsea",2022,"fr FRA","DF",22,1999,6.1,14,7,10,2,2,7,12,58.3,5,6,3,3,11,25,20,0,"Matches","https://fbref.com/en/comps/9/2021-2022/defense/2021-2022-Premier-League-Stats"
"Dane Scarlett","Tottenham",2022,"eng ENG","MF",17,2004,0,0,0,0,0,0,0,0,NA,0,0,0,0,0,0,0,0,"Matches","https://fbref.com/en/comps/9/2021-2022/defense/2021-2022-Premier-League-Stats"
"Fabian Schär","Newcastle Utd",2022,"ch SUI","DF",29,1991,24,16,11,11,3,2,8,16,50,8,27,18,9,32,48,95,2,"Matches","https://fbref.com/en/comps/9/2021-2022/defense/2021-2022-Premier-League-Stats"
"Jeffrey Schlupp","Crystal Palace",2022,"gh GHA","MF,FW",28,1992,20.6,46,25,16,23,7,24,50,48,26,39,9,30,18,64,32,0,"Matches","https://fbref.com/en/comps/9/2021-2022/defense/2021-2022-Premier-League-Stats"
"Kasper Schmeichel","Leicester City",2022,"dk DEN","GK",34,1986,37,0,0,0,0,0,0,2,0,2,0,0,0,1,1,15,2,"Matches","https://fbref.com/en/comps/9/2021-2022/defense/2021-2022-Premier-League-Stats"
"Ken Sema","Watford",2022,"se SWE","MF,FW",27,1993,9.5,16,6,11,4,1,9,20,45,11,10,0,10,5,21,11,0,"Matches","https://fbref.com/en/comps/9/2021-2022/defense/2021-2022-Premier-League-Stats"
"Nélson Semedo","Wolves",2022,"pt POR","MF,DF",27,1993,23.7,58,39,39,17,2,25,49,51,24,23,4,19,21,79,64,1,"Matches","https://fbref.com/en/comps/9/2021-2022/defense/2021-2022-Premier-League-Stats"
"Ryan Sessegnon","Tottenham",2022,"eng ENG","DF,MF",21,2000,11.6,25,19,14,7,4,11,22,50,11,18,3,15,7,32,26,0,"Matches","https://fbref.com/en/comps/9/2021-2022/defense/2021-2022-Premier-League-Stats"
"Jamie Shackleton","Leeds United",2022,"eng ENG","DF,MF",21,1999,7.9,27,16,19,7,1,13,25,52,12,11,7,4,8,35,12,1,"Matches","https://fbref.com/en/comps/9/2021-2022/defense/2021-2022-Premier-League-Stats"
"Luke Shaw","Manchester Utd",2022,"eng ENG","DF",26,1995,17.8,21,13,9,9,3,12,21,57.1,9,22,11,11,9,30,22,2,"Matches","https://fbref.com/en/comps/9/2021-2022/defense/2021-2022-Premier-League-Stats"
"Jonjo Shelvey","Newcastle Utd",2022,"eng ENG","MF",29,1992,22,30,17,12,18,0,14,34,41.2,20,22,7,15,22,52,20,2,"Matches","https://fbref.com/en/comps/9/2021-2022/defense/2021-2022-Premier-League-Stats"
"Shola Shoretire","Manchester Utd",2022,"eng ENG","MF",17,2004,0.2,0,0,0,0,0,0,0,NA,0,0,0,0,0,0,0,0,"Matches","https://fbref.com/en/comps/9/2021-2022/defense/2021-2022-Premier-League-Stats"
"Francisco Sierralta","Watford",2022,"cl CHI","DF",24,1997,4.7,7,3,7,0,0,5,8,62.5,3,7,2,5,6,13,35,0,"Matches","https://fbref.com/en/comps/9/2021-2022/defense/2021-2022-Premier-League-Stats"
"Bernardo Silva","Manchester City",2022,"pt POR","MF,FW",26,1994,31.7,57,29,19,19,19,31,67,46.3,36,24,2,22,20,77,19,0,"Matches","https://fbref.com/en/comps/9/2021-2022/defense/2021-2022-Premier-League-Stats"
"Fábio Silva","Wolves",2022,"pt POR","FW",19,2002,6.4,3,2,0,2,1,0,8,0,8,2,0,2,1,4,1,0,"Matches","https://fbref.com/en/comps/9/2021-2022/defense/2021-2022-Premier-League-Stats"
"Thiago Silva","Chelsea",2022,"br BRA","DF",36,1984,29.4,32,21,19,12,1,11,22,50,11,54,31,23,44,76,100,0,"Matches","https://fbref.com/en/comps/9/2021-2022/defense/2021-2022-Premier-League-Stats"
"Ellis Simms","Everton",2022,"eng ENG","FW",20,2001,0.7,0,0,0,0,0,0,0,NA,0,1,1,0,0,0,1,0,"Matches","https://fbref.com/en/comps/9/2021-2022/defense/2021-2022-Premier-League-Stats"
"Moussa Sissoko","Watford",2022,"fr FRA","MF",31,1989,35.8,53,27,27,20,6,28,42,66.7,14,42,13,29,30,83,64,0,"Matches","https://fbref.com/en/comps/9/2021-2022/defense/2021-2022-Premier-League-Stats"
"Oliver Skipp","Tottenham",2022,"eng ENG","MF",20,2000,15,33,19,14,18,1,15,31,48.4,16,19,7,12,12,45,10,1,"Matches","https://fbref.com/en/comps/9/2021-2022/defense/2021-2022-Premier-League-Stats"
"William Smallbone","Southampton",2022,"ie IRL","MF,FW",21,2000,1.5,4,4,2,2,0,1,3,33.3,2,4,0,4,2,6,0,0,"Matches","https://fbref.com/en/comps/9/2021-2022/defense/2021-2022-Premier-League-Stats"
"Emile Smith Rowe","Arsenal",2022,"eng ENG","MF,FW",21,2000,21.3,14,7,7,7,0,4,20,20,16,18,1,17,15,29,10,1,"Matches","https://fbref.com/en/comps/9/2021-2022/defense/2021-2022-Premier-League-Stats"
"Cédric Soares","Arsenal",2022,"pt POR","DF",29,1991,16.5,38,26,23,9,6,16,25,64,9,18,7,11,16,54,31,1,"Matches","https://fbref.com/en/comps/9/2021-2022/defense/2021-2022-Premier-League-Stats"
"Tomá Soucek","West Ham",2022,"cz CZE","MF",26,1995,34,66,32,27,33,6,28,65,43.1,37,34,13,21,52,118,98,1,"Matches","https://fbref.com/en/comps/9/2021-2022/defense/2021-2022-Premier-League-Stats"
"Boubakary Soumaré","Leicester City",2022,"fr FRA","MF",22,1999,12.2,19,13,10,8,1,8,17,47.1,9,13,1,12,14,33,18,0,"Matches","https://fbref.com/en/comps/9/2021-2022/defense/2021-2022-Premier-League-Stats"
"Çaglar Söyüncü","Leicester City",2022,"tr TUR","DF",25,1996,27.7,47,30,32,12,3,26,42,61.9,16,44,27,17,32,79,115,1,"Matches","https://fbref.com/en/comps/9/2021-2022/defense/2021-2022-Premier-League-Stats"
"Tony Springett","Norwich City",2022,"eng ENG","MF,FW",18,2002,1.6,2,1,1,1,0,1,4,25,3,0,0,0,0,2,2,0,"Matches","https://fbref.com/en/comps/9/2021-2022/defense/2021-2022-Premier-League-Stats"
"Jason Steele","Brighton",2022,"eng ENG","GK",30,1990,1,0,0,0,0,0,0,0,NA,0,0,0,0,0,0,0,0,"Matches","https://fbref.com/en/comps/9/2021-2022/defense/2021-2022-Premier-League-Stats"
"Jed Steer","Aston Villa",2022,"eng ENG","GK",28,1992,1,0,0,0,0,0,0,0,NA,0,0,0,0,0,0,0,0,"Matches","https://fbref.com/en/comps/9/2021-2022/defense/2021-2022-Premier-League-Stats"
"Zack Steffen","Manchester City",2022,"us USA","GK",26,1995,1,0,0,0,0,0,0,0,NA,0,0,0,0,0,0,2,0,"Matches","https://fbref.com/en/comps/9/2021-2022/defense/2021-2022-Premier-League-Stats"
"Dale Stephens","Burnley",2022,"eng ENG","MF",32,1989,1.4,4,1,0,3,1,3,8,37.5,5,4,1,3,1,5,1,0,"Matches","https://fbref.com/en/comps/9/2021-2022/defense/2021-2022-Premier-League-Stats"
"Jack Stephens","Southampton",2022,"eng ENG","DF",27,1994,9,19,12,13,5,1,6,16,37.5,10,12,7,5,19,38,42,0,"Matches","https://fbref.com/en/comps/9/2021-2022/defense/2021-2022-Premier-League-Stats"
"Raheem Sterling","Manchester City",2022,"eng ENG","FW",26,1994,23.6,23,10,3,11,9,10,23,43.5,13,12,0,12,12,35,3,0,"Matches","https://fbref.com/en/comps/9/2021-2022/defense/2021-2022-Premier-League-Stats"
"Finley Stevens","Brentford",2022,"wls WAL","DF",18,2003,0.2,3,1,0,3,0,1,1,100,0,0,0,0,0,3,0,0,"Matches","https://fbref.com/en/comps/9/2021-2022/defense/2021-2022-Premier-League-Stats"
"John Stones","Manchester City",2022,"eng ENG","DF",27,1994,12.4,5,3,3,2,0,2,3,66.7,1,3,3,0,11,16,27,1,"Matches","https://fbref.com/en/comps/9/2021-2022/defense/2021-2022-Premier-League-Stats"
"Pascal Struijk","Leeds United",2022,"nl NED","DF,MF",21,1999,22.8,61,39,34,23,4,30,50,60,20,35,23,12,33,94,60,2,"Matches","https://fbref.com/en/comps/9/2021-2022/defense/2021-2022-Premier-League-Stats"
"Crysencio Summerville","Leeds United",2022,"nl NED","MF,FW",19,2001,1.4,5,3,1,1,3,2,3,66.7,1,2,0,2,2,7,0,0,"Matches","https://fbref.com/en/comps/9/2021-2022/defense/2021-2022-Premier-League-Stats"
"Jakob Sørensen","Norwich City",2022,"dk DEN","MF,DF",23,1998,6.7,22,11,6,14,2,10,20,50,10,7,3,4,10,32,19,0,"Matches","https://fbref.com/en/comps/9/2021-2022/defense/2021-2022-Premier-League-Stats"
"Japhet Tanganga","Tottenham",2022,"eng ENG","DF",22,1999,8.2,14,8,7,6,1,9,19,47.4,10,13,5,8,9,23,31,0,"Matches","https://fbref.com/en/comps/9/2021-2022/defense/2021-2022-Premier-League-Stats"
"Matt Targett","Aston Villa",2022,"eng ENG","DF",25,1995,15.9,34,18,28,5,1,24,45,53.3,21,16,9,7,23,57,35,0,"Matches","https://fbref.com/en/comps/9/2021-2022/defense/2021-2022-Premier-League-Stats"
"Matt Targett","Newcastle Utd",2022,"eng ENG","DF",25,1995,16,41,26,26,14,1,24,37,64.9,13,15,4,11,25,66,39,1,"Matches","https://fbref.com/en/comps/9/2021-2022/defense/2021-2022-Premier-League-Stats"
"James Tarkowski","Burnley",2022,"eng ENG","DF",28,1992,34.5,65,45,47,17,1,33,47,70.2,14,75,61,14,48,113,186,4,"Matches","https://fbref.com/en/comps/9/2021-2022/defense/2021-2022-Premier-League-Stats"
"Nuno Tavares","Arsenal",2022,"pt POR","DF",21,2000,13.1,21,14,10,7,4,8,18,44.4,10,15,5,10,9,30,33,1,"Matches","https://fbref.com/en/comps/9/2021-2022/defense/2021-2022-Premier-League-Stats"
"Charlie Taylor","Burnley",2022,"eng ENG","DF",27,1993,30.3,45,26,31,11,3,26,44,59.1,18,42,20,22,58,103,95,2,"Matches","https://fbref.com/en/comps/9/2021-2022/defense/2021-2022-Premier-League-Stats"
"Nathan Tella","Southampton",2022,"eng ENG","MF,FW",22,1999,8.9,13,9,5,7,1,6,17,35.3,11,13,0,13,6,19,9,0,"Matches","https://fbref.com/en/comps/9/2021-2022/defense/2021-2022-Premier-League-Stats"
"Alex Telles","Manchester Utd",2022,"br BRA","DF",28,1992,18.4,48,27,35,9,4,27,43,62.8,16,17,4,13,26,74,45,0,"Matches","https://fbref.com/en/comps/9/2021-2022/defense/2021-2022-Premier-League-Stats"
"Luke Thomas","Leicester City",2022,"eng ENG","DF",20,2001,21.2,50,31,33,13,4,28,65,43.1,37,35,14,21,40,90,55,0,"Matches","https://fbref.com/en/comps/9/2021-2022/defense/2021-2022-Premier-League-Stats"
"Dominic Thompson","Brentford",2022,"eng ENG","DF",21,2000,1.6,1,0,1,0,0,0,1,0,1,2,2,0,2,3,3,0,"Matches","https://fbref.com/en/comps/9/2021-2022/defense/2021-2022-Premier-League-Stats"
"Youri Tielemans","Leicester City",2022,"be BEL","MF",24,1997,29.2,74,38,23,45,6,42,100,42,58,47,13,34,21,95,41,3,"Matches","https://fbref.com/en/comps/9/2021-2022/defense/2021-2022-Premier-League-Stats"
"Kieran Tierney","Arsenal",2022,"sct SCO","DF",24,1997,21.3,18,14,11,7,0,10,11,90.9,1,23,5,18,15,33,54,0,"Matches","https://fbref.com/en/comps/9/2021-2022/defense/2021-2022-Premier-League-Stats"
"Takehiro Tomiyasu","Arsenal",2022,"jp JPN","DF",22,1998,18.7,35,17,19,13,3,21,32,65.6,11,22,3,19,24,59,64,2,"Matches","https://fbref.com/en/comps/9/2021-2022/defense/2021-2022-Premier-League-Stats"
"James Tomkins","Crystal Palace",2022,"eng ENG","DF",32,1989,6.1,8,3,6,2,0,6,8,75,2,8,8,0,4,12,18,0,"Matches","https://fbref.com/en/comps/9/2021-2022/defense/2021-2022-Premier-League-Stats"
"Ivan Toney","Brentford",2022,"eng ENG","FW",25,1996,32.3,33,21,5,20,8,12,38,31.6,26,16,2,14,14,47,44,1,"Matches","https://fbref.com/en/comps/9/2021-2022/defense/2021-2022-Premier-League-Stats"
"Ferrán Torres","Manchester City",2022,"es ESP","FW",21,2000,3.4,2,2,0,1,1,0,3,0,3,2,0,2,0,2,1,0,"Matches","https://fbref.com/en/comps/9/2021-2022/defense/2021-2022-Premier-League-Stats"
"Cenk Tosun","Everton",2022,"tr TUR","MF",30,1991,0.1,0,0,0,0,0,0,0,NA,0,0,0,0,0,0,0,0,"Matches","https://fbref.com/en/comps/9/2021-2022/defense/2021-2022-Premier-League-Stats"
"Andros Townsend","Everton",2022,"eng ENG","MF,FW",30,1991,16.2,31,17,15,6,10,15,40,37.5,25,28,2,26,14,45,6,1,"Matches","https://fbref.com/en/comps/9/2021-2022/defense/2021-2022-Premier-League-Stats"
"Adama Traoré","Wolves",2022,"es ESP","FW,MF",25,1996,11.9,8,3,6,0,2,3,7,42.9,4,4,1,3,2,10,1,0,"Matches","https://fbref.com/en/comps/9/2021-2022/defense/2021-2022-Premier-League-Stats"
"Bertrand Traoré","Aston Villa",2022,"bf BFA","MF,FW",25,1995,2.4,3,3,0,1,2,1,2,50,1,0,0,0,0,3,1,0,"Matches","https://fbref.com/en/comps/9/2021-2022/defense/2021-2022-Premier-League-Stats"
"Trézéguet","Aston Villa",2022,"eg EGY","FW",26,1994,0.1,0,0,0,0,0,0,0,NA,0,0,0,0,0,0,0,0,"Matches","https://fbref.com/en/comps/9/2021-2022/defense/2021-2022-Premier-League-Stats"
"Francisco Trincão","Wolves",2022,"pt POR","FW,MF",21,1999,14.8,28,15,9,13,6,3,19,15.8,16,17,1,16,12,40,1,1,"Matches","https://fbref.com/en/comps/9/2021-2022/defense/2021-2022-Premier-League-Stats"
"Kieran Trippier","Newcastle Utd",2022,"eng ENG","DF",30,1990,4.8,17,10,8,8,1,10,16,62.5,6,10,3,7,10,27,10,0,"Matches","https://fbref.com/en/comps/9/2021-2022/defense/2021-2022-Premier-League-Stats"
"William Troost-Ekong","Watford",2022,"ng NGA","DF",27,1993,15.4,18,9,11,6,1,10,15,66.7,5,24,14,10,7,25,82,1,"Matches","https://fbref.com/en/comps/9/2021-2022/defense/2021-2022-Premier-League-Stats"
"Leandro Trossard","Brighton",2022,"be BEL","FW,MF",26,1994,31.2,34,20,12,9,13,4,31,12.9,27,33,4,29,15,49,10,0,"Matches","https://fbref.com/en/comps/9/2021-2022/defense/2021-2022-Premier-League-Stats"
"Kostas Tsimikas","Liverpool",2022,"gr GRE","DF",25,1996,9.7,27,12,12,8,7,12,16,75,4,6,2,4,10,37,22,2,"Matches","https://fbref.com/en/comps/9/2021-2022/defense/2021-2022-Premier-League-Stats"
"Axel Tuanzebe","Aston Villa",2022,"eng ENG","DF",23,1997,5.6,5,3,3,2,0,2,5,40,3,5,4,1,5,10,12,1,"Matches","https://fbref.com/en/comps/9/2021-2022/defense/2021-2022-Premier-League-Stats"
"Ozan Tufan","Watford",2022,"tr TUR","MF",26,1995,3.7,3,2,1,1,1,1,5,20,4,2,0,2,2,5,4,0,"Matches","https://fbref.com/en/comps/9/2021-2022/defense/2021-2022-Premier-League-Stats"
"Christos Tzolis","Norwich City",2022,"gr GRE","FW,MF",19,2002,3.7,5,3,3,1,1,2,9,22.2,7,3,0,3,1,6,1,0,"Matches","https://fbref.com/en/comps/9/2021-2022/defense/2021-2022-Premier-League-Stats"
"Yan Valery","Southampton",2022,"tn TUN","DF",22,1999,4.1,8,6,4,3,1,4,9,44.4,5,6,3,3,6,14,19,1,"Matches","https://fbref.com/en/comps/9/2021-2022/defense/2021-2022-Premier-League-Stats"
"Virgil van Dijk","Liverpool",2022,"nl NED","DF",30,1991,34,16,10,11,5,0,11,16,68.8,5,21,14,7,31,47,109,0,"Matches","https://fbref.com/en/comps/9/2021-2022/defense/2021-2022-Premier-League-Stats"
"Raphaël Varane","Manchester Utd",2022,"fr FRA","DF",28,1993,20.3,28,19,21,6,1,10,22,45.5,12,18,9,9,18,46,82,1,"Matches","https://fbref.com/en/comps/9/2021-2022/defense/2021-2022-Premier-League-Stats"
"Jamie Vardy","Leicester City",2022,"eng ENG","FW",34,1987,20.1,6,5,0,4,2,1,7,14.3,6,9,0,9,1,7,17,0,"Matches","https://fbref.com/en/comps/9/2021-2022/defense/2021-2022-Premier-League-Stats"
"Joël Veltman","Brighton",2022,"nl NED","DF",29,1992,31.9,74,48,47,21,6,21,53,39.6,32,46,16,30,45,119,89,0,"Matches","https://fbref.com/en/comps/9/2021-2022/defense/2021-2022-Premier-League-Stats"
"Jannik Vestergaard","Leicester City",2022,"dk DEN","DF",28,1992,6.3,15,10,12,3,0,8,15,53.3,7,10,8,2,7,22,36,0,"Matches","https://fbref.com/en/comps/9/2021-2022/defense/2021-2022-Premier-League-Stats"
"Nikola Vlaic","West Ham",2022,"hr CRO","FW,MF",23,1997,6.2,11,7,4,6,1,5,20,25,15,4,0,4,2,13,1,0,"Matches","https://fbref.com/en/comps/9/2021-2022/defense/2021-2022-Premier-League-Stats"
"Matej Vydra","Burnley",2022,"cz CZE","FW",29,1992,7.5,12,7,3,4,5,3,7,42.9,4,5,1,4,0,12,9,0,"Matches","https://fbref.com/en/comps/9/2021-2022/defense/2021-2022-Premier-League-Stats"
"Theo Walcott","Southampton",2022,"eng ENG","MF,FW",32,1989,4.2,4,2,2,0,2,1,5,20,4,3,0,3,5,9,2,0,"Matches","https://fbref.com/en/comps/9/2021-2022/defense/2021-2022-Premier-League-Stats"
"Kyle Walker","Manchester City",2022,"eng ENG","DF",31,1990,19.5,15,6,7,7,1,8,17,47.1,9,14,4,10,14,29,16,1,"Matches","https://fbref.com/en/comps/9/2021-2022/defense/2021-2022-Premier-League-Stats"
"Kyle Walker-Peters","Southampton",2022,"eng ENG","DF",24,1997,29.3,57,33,28,21,8,26,38,68.4,12,29,8,21,37,94,53,1,"Matches","https://fbref.com/en/comps/9/2021-2022/defense/2021-2022-Premier-League-Stats"
"Aaron Wan-Bissaka","Manchester Utd",2022,"eng ENG","DF",23,1997,19.9,49,36,25,18,6,14,20,70,6,24,14,10,34,83,41,2,"Matches","https://fbref.com/en/comps/9/2021-2022/defense/2021-2022-Premier-League-Stats"
"Danny Ward","Leicester City",2022,"wls WAL","GK",28,1993,1,0,0,0,0,0,0,0,NA,0,0,0,0,0,0,1,0,"Matches","https://fbref.com/en/comps/9/2021-2022/defense/2021-2022-Premier-League-Stats"
"Joel Ward","Crystal Palace",2022,"eng ENG","DF",31,1989,27.6,44,26,30,11,3,30,57,52.6,27,24,11,13,32,76,107,1,"Matches","https://fbref.com/en/comps/9/2021-2022/defense/2021-2022-Premier-League-Stats"
"James Ward-Prowse","Southampton",2022,"eng ENG","MF",26,1994,35.7,41,24,12,24,5,19,70,27.1,51,43,15,28,40,81,45,1,"Matches","https://fbref.com/en/comps/9/2021-2022/defense/2021-2022-Premier-League-Stats"
"Ollie Watkins","Aston Villa",2022,"eng ENG","FW",25,1995,32.8,17,13,2,7,8,2,15,13.3,13,25,3,22,12,29,27,0,"Matches","https://fbref.com/en/comps/9/2021-2022/defense/2021-2022-Premier-League-Stats"
"Adam Webster","Brighton",2022,"eng ENG","DF",26,1995,15.9,26,8,17,7,2,13,20,65,7,25,17,8,17,43,66,2,"Matches","https://fbref.com/en/comps/9/2021-2022/defense/2021-2022-Premier-League-Stats"
"Wout Weghorst","Burnley",2022,"nl NED","FW",28,1992,16.1,17,9,3,9,5,6,19,31.6,13,16,5,11,6,23,13,0,"Matches","https://fbref.com/en/comps/9/2021-2022/defense/2021-2022-Premier-League-Stats"
"Danny Welbeck","Brighton",2022,"eng ENG","FW,MF",30,1990,16.4,14,7,2,8,4,3,10,30,7,18,2,16,5,19,18,0,"Matches","https://fbref.com/en/comps/9/2021-2022/defense/2021-2022-Premier-League-Stats"
"Timo Werner","Chelsea",2022,"de GER","FW,MF",25,1996,14.3,8,4,3,3,2,2,20,10,18,9,0,9,2,10,4,0,"Matches","https://fbref.com/en/comps/9/2021-2022/defense/2021-2022-Premier-League-Stats"
"Ashley Westwood","Burnley",2022,"eng ENG","MF",31,1990,25.4,21,12,8,12,1,10,31,32.3,21,21,9,12,30,51,16,1,"Matches","https://fbref.com/en/comps/9/2021-2022/defense/2021-2022-Premier-League-Stats"
"Ben White","Arsenal",2022,"eng ENG","DF",23,1997,32,44,23,30,8,6,28,45,62.2,17,42,24,18,42,86,102,0,"Matches","https://fbref.com/en/comps/9/2021-2022/defense/2021-2022-Premier-League-Stats"
"Brandon Williams","Norwich City",2022,"eng ENG","DF",20,2000,23.6,55,37,35,18,2,36,64,56.3,28,26,6,20,44,99,50,0,"Matches","https://fbref.com/en/comps/9/2021-2022/defense/2021-2022-Premier-League-Stats"
"Neco Williams","Liverpool",2022,"wls WAL","DF",20,2001,0.1,0,0,0,0,0,0,0,NA,0,0,0,0,0,0,0,0,"Matches","https://fbref.com/en/comps/9/2021-2022/defense/2021-2022-Premier-League-Stats"
"Joe Willock","Newcastle Utd",2022,"eng ENG","MF",21,1999,22.6,64,37,30,28,6,29,68,42.6,39,37,6,31,21,85,10,1,"Matches","https://fbref.com/en/comps/9/2021-2022/defense/2021-2022-Premier-League-Stats"
"Callum Wilson","Newcastle Utd",2022,"eng ENG","FW",29,1992,15.4,9,8,1,5,3,1,4,25,3,7,2,5,3,12,10,0,"Matches","https://fbref.com/en/comps/9/2021-2022/defense/2021-2022-Premier-League-Stats"
"Harry Winks","Tottenham",2022,"eng ENG","MF",25,1996,10.1,15,10,4,9,2,8,21,38.1,13,14,3,11,16,31,10,2,"Matches","https://fbref.com/en/comps/9/2021-2022/defense/2021-2022-Premier-League-Stats"
"Yoane Wissa","Brentford",2022,"cd COD","FW",24,1996,14.3,12,6,5,4,3,1,16,6.3,15,12,5,7,8,20,6,0,"Matches","https://fbref.com/en/comps/9/2021-2022/defense/2021-2022-Premier-League-Stats"
"Chris Wood","Burnley",2022,"nz NZL","FW",29,1991,15.2,7,5,0,3,4,3,10,30,7,13,4,9,0,7,3,0,"Matches","https://fbref.com/en/comps/9/2021-2022/defense/2021-2022-Premier-League-Stats"
"Chris Wood","Newcastle Utd",2022,"nz NZL","FW",29,1991,14.7,2,0,1,1,0,1,2,50,1,5,2,3,2,4,9,0,"Matches","https://fbref.com/en/comps/9/2021-2022/defense/2021-2022-Premier-League-Stats"
"Freddie Woodman","Newcastle Utd",2022,"eng ENG","GK",24,1997,4,0,0,0,0,0,0,0,NA,0,0,0,0,0,0,0,1,"Matches","https://fbref.com/en/comps/9/2021-2022/defense/2021-2022-Premier-League-Stats"
"Granit Xhaka","Arsenal",2022,"ch SUI","MF,DF",28,1992,25.9,32,18,16,12,4,16,41,39,25,21,6,15,21,53,31,0,"Matches","https://fbref.com/en/comps/9/2021-2022/defense/2021-2022-Premier-League-Stats"
"Andriy Yarmolenko","West Ham",2022,"ua UKR","FW,MF",31,1989,3.5,4,2,2,2,0,2,8,25,6,4,2,2,0,4,2,0,"Matches","https://fbref.com/en/comps/9/2021-2022/defense/2021-2022-Premier-League-Stats"
"Ashley Young","Aston Villa",2022,"eng ENG","DF,FW",36,1985,13.9,18,6,9,6,3,11,16,68.8,5,10,4,6,13,31,25,1,"Matches","https://fbref.com/en/comps/9/2021-2022/defense/2021-2022-Premier-League-Stats"
"Nathan Young-Coombes","Brentford",2022,"eng ENG","MF",18,2003,0,0,0,0,0,0,0,0,NA,0,0,0,0,0,0,0,0,"Matches","https://fbref.com/en/comps/9/2021-2022/defense/2021-2022-Premier-League-Stats"
"Wilfried Zaha","Crystal Palace",2022,"ci CIV","FW",28,1992,30.7,40,20,14,15,11,10,31,32.3,21,28,0,28,5,45,5,0,"Matches","https://fbref.com/en/comps/9/2021-2022/defense/2021-2022-Premier-League-Stats"
"Christoph Zimmermann","Norwich City",2022,"de GER","DF",28,1993,1.7,6,3,5,1,0,3,4,75,1,0,0,0,1,7,4,0,"Matches","https://fbref.com/en/comps/9/2021-2022/defense/2021-2022-Premier-League-Stats"
"Oleksandr Zinchenko","Manchester City",2022,"ua UKR","DF",24,1996,11.6,20,14,7,10,3,11,20,55,9,11,3,8,14,34,15,1,"Matches","https://fbref.com/en/comps/9/2021-2022/defense/2021-2022-Premier-League-Stats"
"Hakim Ziyech","Chelsea",2022,"ma MAR","MF,FW",28,1993,14.7,19,10,5,12,2,10,36,27.8,26,11,1,10,10,29,10,0,"Matches","https://fbref.com/en/comps/9/2021-2022/defense/2021-2022-Premier-League-Stats"
"Kurt Zouma","West Ham",2022,"fr FRA","DF",26,1994,23.1,11,6,8,3,0,4,7,57.1,3,31,26,5,34,45,132,0,"Matches","https://fbref.com/en/comps/9/2021-2022/defense/2021-2022-Premier-League-Stats"
"Martin Ødegaard","Arsenal",2022,"no NOR","MF,FW",22,1998,30.9,49,21,6,24,19,22,61,36.1,39,18,1,17,11,60,11,1,"Matches","https://fbref.com/en/comps/9/2021-2022/defense/2021-2022-Premier-League-Stats"
