"Player","Squad","Season","Nation","Pos","Age","Born","Mins_Per_90","Tkl_Tackles","TklW_Tackles","Def 3rd_Tackles","Mid 3rd_Tackles","Att 3rd_Tackles","Tkl_Challenges","Att_Challenges","Tkl_percent_Challenges","Lost_Challenges","Blocks_Blocks","Sh_Blocks","Pass_Blocks","Int","Tkl+Int","Clr","Err","Matches","url"
"Patrick van Aanholt","Crystal Palace",2019,"nl NED","DF",27,1990,35.5,48,24,35,11,2,24,40,60,16,33,9,24,40,88,91,2,"Matches","https://fbref.com/en/comps/9/2018-2019/defense/2018-2019-Premier-League-Stats"
"Sergio Agüero","Manchester City",2019,"ar ARG","FW",30,1988,27.3,17,9,1,10,6,5,9,55.6,4,15,1,14,9,26,3,0,"Matches","https://fbref.com/en/comps/9/2018-2019/defense/2018-2019-Premier-League-Stats"
"Nathan Aké","Bournemouth",2019,"nl NED","DF",23,1995,37.9,66,35,42,21,3,22,35,62.9,13,51,35,16,32,98,241,0,"Matches","https://fbref.com/en/comps/9/2018-2019/defense/2018-2019-Premier-League-Stats"
"Marc Albrighton","Leicester City",2019,"eng ENG","FW,MF",28,1989,18.1,35,22,18,14,3,13,31,41.9,18,26,3,23,23,58,30,0,"Matches","https://fbref.com/en/comps/9/2018-2019/defense/2018-2019-Premier-League-Stats"
"Toby Alderweireld","Tottenham",2019,"be BEL","DF",29,1989,32.5,37,23,25,10,2,12,22,54.5,10,41,22,19,24,61,175,0,"Matches","https://fbref.com/en/comps/9/2018-2019/defense/2018-2019-Premier-League-Stats"
"Trent Alexander-Arnold","Liverpool",2019,"eng ENG","DF",19,1998,27.4,61,39,31,22,8,36,68,52.9,32,19,3,16,35,96,68,0,"Matches","https://fbref.com/en/comps/9/2018-2019/defense/2018-2019-Premier-League-Stats"
"Alisson","Liverpool",2019,"br BRA","GK",25,1992,38,2,1,2,0,0,2,2,100,0,0,0,0,1,3,14,6,"Matches","https://fbref.com/en/comps/9/2018-2019/defense/2018-2019-Premier-League-Stats"
"Dele Alli","Tottenham",2019,"eng ENG","MF",22,1996,20.3,33,19,6,14,13,5,24,20.8,19,33,5,28,19,52,20,0,"Matches","https://fbref.com/en/comps/9/2018-2019/defense/2018-2019-Premier-League-Stats"
"Miguel Almirón","Newcastle Utd",2019,"py PAR","MF",24,1994,8.4,20,12,7,10,3,4,10,40,6,14,1,13,8,28,5,0,"Matches","https://fbref.com/en/comps/9/2018-2019/defense/2018-2019-Premier-League-Stats"
"Marcos Alonso","Chelsea",2019,"es ESP","DF",27,1990,30.7,73,46,44,22,7,33,58,56.9,25,25,2,23,39,112,101,0,"Matches","https://fbref.com/en/comps/9/2018-2019/defense/2018-2019-Premier-League-Stats"
"Daniel Amartey","Leicester City",2019,"gh GHA","DF",23,1994,7.1,18,12,11,6,1,10,15,66.7,5,6,4,2,17,35,28,1,"Matches","https://fbref.com/en/comps/9/2018-2019/defense/2018-2019-Premier-League-Stats"
"Luke Amos","Tottenham",2019,"eng ENG","MF",21,1997,0,1,0,0,1,0,0,0,NA,0,0,0,0,0,1,0,0,"Matches","https://fbref.com/en/comps/9/2018-2019/defense/2018-2019-Premier-League-Stats"
"Felipe Anderson","West Ham",2019,"br BRA","MF,FW",25,1993,33.8,89,49,33,44,12,31,101,30.7,70,71,0,71,41,130,18,1,"Matches","https://fbref.com/en/comps/9/2018-2019/defense/2018-2019-Premier-League-Stats"
"Florin Andone","Brighton",2019,"ro ROU","FW",25,1993,9.8,10,2,3,4,3,1,6,16.7,5,9,1,8,3,13,12,0,"Matches","https://fbref.com/en/comps/9/2018-2019/defense/2018-2019-Premier-League-Stats"
"Michail Antonio","West Ham",2019,"jm JAM","MF,FW",28,1990,23.4,23,14,12,6,5,6,12,50,6,38,3,35,18,41,26,1,"Matches","https://fbref.com/en/comps/9/2018-2019/defense/2018-2019-Premier-League-Stats"
"Stuart Armstrong","Southampton",2019,"sct SCO","MF",26,1992,15.9,28,20,14,6,8,8,42,19,34,14,0,14,12,40,12,0,"Matches","https://fbref.com/en/comps/9/2018-2019/defense/2018-2019-Premier-League-Stats"
"Marko Arnautovic","West Ham",2019,"at AUT","FW",29,1989,22.1,9,5,4,3,2,1,7,14.3,6,4,2,2,3,12,6,0,"Matches","https://fbref.com/en/comps/9/2018-2019/defense/2018-2019-Premier-League-Stats"
"Kepa Arrizabalaga","Chelsea",2019,"es ESP","GK",23,1994,36,1,1,1,0,0,1,2,50,1,1,0,1,0,1,4,2,"Matches","https://fbref.com/en/comps/9/2018-2019/defense/2018-2019-Premier-League-Stats"
"Harry Arter","Cardiff City",2019,"ie IRL","MF",28,1989,22.2,62,37,27,26,9,16,46,34.8,30,33,5,28,21,83,21,2,"Matches","https://fbref.com/en/comps/9/2018-2019/defense/2018-2019-Premier-League-Stats"
"Christian Atsu","Newcastle Utd",2019,"gh GHA","MF",26,1992,16.6,24,15,9,11,4,5,16,31.3,11,13,3,10,7,31,16,0,"Matches","https://fbref.com/en/comps/9/2018-2019/defense/2018-2019-Premier-League-Stats"
"Pierre-Emerick Aubameyang","Arsenal",2019,"ga GAB","FW",29,1989,30.3,21,17,6,9,6,8,28,28.6,20,26,0,26,8,29,22,0,"Matches","https://fbref.com/en/comps/9/2018-2019/defense/2018-2019-Premier-League-Stats"
"Serge Aurier","Tottenham",2019,"ci CIV","DF",25,1992,6.3,20,12,12,4,4,8,15,53.3,7,8,2,6,7,27,20,0,"Matches","https://fbref.com/en/comps/9/2018-2019/defense/2018-2019-Premier-League-Stats"
"Charlie Austin","Southampton",2019,"eng ENG","FW",29,1989,10.9,13,7,3,6,4,6,11,54.5,5,12,2,10,2,15,13,0,"Matches","https://fbref.com/en/comps/9/2018-2019/defense/2018-2019-Premier-League-Stats"
"Jordan Ayew","Crystal Palace",2019,"gh GHA","FW",26,1991,13.1,38,23,12,19,7,6,20,30,14,16,0,16,7,45,6,0,"Matches","https://fbref.com/en/comps/9/2018-2019/defense/2018-2019-Premier-League-Stats"
"Floyd Ayité","Fulham",2019,"tg TOG","FW,MF",29,1988,5.3,4,4,2,1,1,2,6,33.3,4,8,1,7,7,11,5,0,"Matches","https://fbref.com/en/comps/9/2018-2019/defense/2018-2019-Premier-League-Stats"
"César Azpilicueta","Chelsea",2019,"es ESP","DF",28,1989,37.8,105,60,52,40,13,38,67,56.7,29,63,16,47,43,148,91,3,"Matches","https://fbref.com/en/comps/9/2018-2019/defense/2018-2019-Premier-League-Stats"
"Ryan Babel","Fulham",2019,"nl NED","FW,MF",31,1986,13.9,8,4,1,5,2,3,9,33.3,6,12,0,12,6,14,13,1,"Matches","https://fbref.com/en/comps/9/2018-2019/defense/2018-2019-Premier-League-Stats"
"Juninho Bacuna","Huddersfield",2019,"cw CUW","MF,DF",20,1997,15.7,46,29,22,19,5,22,54,40.7,32,21,1,20,24,70,12,1,"Matches","https://fbref.com/en/comps/9/2018-2019/defense/2018-2019-Premier-League-Stats"
"Leandro Bacuna","Cardiff City",2019,"cw CUW","MF",26,1991,6.2,15,10,5,7,3,8,22,36.4,14,5,2,3,15,30,9,0,"Matches","https://fbref.com/en/comps/9/2018-2019/defense/2018-2019-Premier-League-Stats"
"Eric Bailly","Manchester Utd",2019,"ci CIV","DF",24,1994,7.1,15,9,14,1,0,8,10,80,2,9,4,5,13,28,39,1,"Matches","https://fbref.com/en/comps/9/2018-2019/defense/2018-2019-Premier-League-Stats"
"Leighton Baines","Everton",2019,"eng ENG","DF",33,1984,4.2,8,6,4,3,1,4,6,66.7,2,2,0,2,2,10,8,0,"Matches","https://fbref.com/en/comps/9/2018-2019/defense/2018-2019-Premier-League-Stats"
"Fabián Balbuena","West Ham",2019,"py PAR","DF",26,1991,22.4,40,20,34,6,0,16,42,38.1,26,23,15,8,53,93,175,0,"Matches","https://fbref.com/en/comps/9/2018-2019/defense/2018-2019-Premier-League-Stats"
"Leon Balogun","Brighton",2019,"ng NGA","DF",30,1988,6.6,12,6,11,1,0,8,9,88.9,1,5,3,2,17,29,32,1,"Matches","https://fbref.com/en/comps/9/2018-2019/defense/2018-2019-Premier-League-Stats"
"Sol Bamba","Cardiff City",2019,"ci CIV","DF",33,1985,27.5,74,42,44,30,0,31,55,56.4,24,72,32,40,82,156,181,3,"Matches","https://fbref.com/en/comps/9/2018-2019/defense/2018-2019-Premier-League-Stats"
"Phil Bardsley","Burnley",2019,"sct SCO","DF",33,1985,18.6,32,19,15,14,3,12,21,57.1,9,25,12,13,31,63,68,1,"Matches","https://fbref.com/en/comps/9/2018-2019/defense/2018-2019-Premier-League-Stats"
"Ross Barkley","Chelsea",2019,"eng ENG","MF",24,1993,13.8,15,10,5,7,3,4,14,28.6,10,8,1,7,9,24,17,2,"Matches","https://fbref.com/en/comps/9/2018-2019/defense/2018-2019-Premier-League-Stats"
"Ashley Barnes","Burnley",2019,"eng ENG","FW",28,1989,26.5,28,17,4,17,7,6,29,20.7,23,29,8,21,2,30,25,0,"Matches","https://fbref.com/en/comps/9/2018-2019/defense/2018-2019-Premier-League-Stats"
"Harvey Barnes","Leicester City",2019,"eng ENG","MF,FW",20,1997,11.2,10,6,5,4,1,4,6,66.7,2,7,1,6,3,13,7,0,"Matches","https://fbref.com/en/comps/9/2018-2019/defense/2018-2019-Premier-League-Stats"
"Antonio Barreca","Newcastle Utd",2019,"it ITA","DF",23,1995,0.1,0,0,0,0,0,0,0,NA,0,0,0,0,0,0,0,0,"Matches","https://fbref.com/en/comps/9/2018-2019/defense/2018-2019-Premier-League-Stats"
"Michy Batshuayi","Crystal Palace",2019,"be BEL","FW",24,1993,8.3,2,1,1,1,0,1,2,50,1,8,3,5,3,5,0,0,"Matches","https://fbref.com/en/comps/9/2018-2019/defense/2018-2019-Premier-League-Stats"
"Jan Bednarek","Southampton",2019,"pl POL","DF",22,1996,23.9,41,25,25,16,0,21,37,56.8,16,44,27,17,71,112,171,0,"Matches","https://fbref.com/en/comps/9/2018-2019/defense/2018-2019-Premier-League-Stats"
"Asmir Begovic","Bournemouth",2019,"ba BIH","GK",31,1987,24,0,0,0,0,0,0,3,0,3,1,0,1,1,1,15,7,"Matches","https://fbref.com/en/comps/9/2018-2019/defense/2018-2019-Premier-League-Stats"
"Héctor Bellerín","Arsenal",2019,"es ESP","DF",23,1995,17,15,12,8,4,3,6,13,46.2,7,17,5,12,20,35,37,3,"Matches","https://fbref.com/en/comps/9/2018-2019/defense/2018-2019-Premier-League-Stats"
"Joe Bennett","Cardiff City",2019,"eng ENG","DF",28,1990,29.3,50,29,34,16,0,22,38,57.9,16,30,8,22,60,110,93,0,"Matches","https://fbref.com/en/comps/9/2018-2019/defense/2018-2019-Premier-League-Stats"
"Ryan Bennett","Wolves",2019,"eng ENG","DF",28,1990,34,58,32,41,16,1,25,41,61,16,42,21,21,43,101,131,1,"Matches","https://fbref.com/en/comps/9/2018-2019/defense/2018-2019-Premier-League-Stats"
"Christian Benteke","Crystal Palace",2019,"be BEL","FW",27,1990,9,5,1,0,4,1,1,4,25,3,7,2,5,0,5,14,0,"Matches","https://fbref.com/en/comps/9/2018-2019/defense/2018-2019-Premier-League-Stats"
"Jóhann Berg Guðmundsson","Burnley",2019,"is ISL","MF",27,1990,19.5,27,11,14,10,3,16,34,47.1,18,25,4,21,33,60,34,0,"Matches","https://fbref.com/en/comps/9/2018-2019/defense/2018-2019-Premier-League-Stats"
"Bernard","Everton",2019,"br BRA","FW,MF",25,1992,23.5,49,30,19,22,8,15,55,27.3,40,37,2,35,27,76,14,1,"Matches","https://fbref.com/en/comps/9/2018-2019/defense/2018-2019-Premier-League-Stats"
"Bernardo","Brighton",2019,"br BRA","DF",23,1995,19.5,62,43,43,13,6,31,45,68.9,14,32,13,19,34,96,82,0,"Matches","https://fbref.com/en/comps/9/2018-2019/defense/2018-2019-Premier-League-Stats"
"Ryan Bertrand","Southampton",2019,"eng ENG","DF",28,1989,24,46,27,22,20,4,16,31,51.6,15,27,5,22,28,74,51,0,"Matches","https://fbref.com/en/comps/9/2018-2019/defense/2018-2019-Premier-League-Stats"
"Marcus Bettinelli","Fulham",2019,"eng ENG","GK",26,1992,7,0,0,0,0,0,0,0,NA,0,0,0,0,0,0,5,0,"Matches","https://fbref.com/en/comps/9/2018-2019/defense/2018-2019-Premier-League-Stats"
"Philip Billing","Huddersfield",2019,"dk DEN","MF",22,1996,24.3,73,44,26,39,8,19,42,45.2,23,57,16,41,53,126,43,0,"Matches","https://fbref.com/en/comps/9/2018-2019/defense/2018-2019-Premier-League-Stats"
"Yves Bissouma","Brighton",2019,"ml MLI","MF",21,1996,19.7,62,30,33,27,2,20,38,52.6,18,21,5,16,33,95,29,2,"Matches","https://fbref.com/en/comps/9/2018-2019/defense/2018-2019-Premier-League-Stats"
"Willy Boly","Wolves",2019,"ci CIV","DF",27,1991,35.2,85,52,49,34,2,34,56,60.7,22,55,32,23,72,157,177,6,"Matches","https://fbref.com/en/comps/9/2018-2019/defense/2018-2019-Premier-League-Stats"
"Léo Bonatini","Wolves",2019,"br BRA","FW",24,1994,1.5,1,1,0,0,1,1,5,20,4,1,0,1,0,1,0,0,"Matches","https://fbref.com/en/comps/9/2018-2019/defense/2018-2019-Premier-League-Stats"
"Gaëtan Bong","Brighton",2019,"cm CMR","DF",30,1988,20.1,16,10,7,6,3,6,10,60,4,16,6,10,25,41,57,2,"Matches","https://fbref.com/en/comps/9/2018-2019/defense/2018-2019-Premier-League-Stats"
"Artur Boruc","Bournemouth",2019,"pl POL","GK",38,1980,12,1,0,1,0,0,1,3,33.3,2,0,0,0,0,1,1,0,"Matches","https://fbref.com/en/comps/9/2018-2019/defense/2018-2019-Premier-League-Stats"
"Robbie Brady","Burnley",2019,"ie IRL","MF",26,1992,8,15,7,5,5,5,6,17,35.3,11,7,1,6,7,22,18,1,"Matches","https://fbref.com/en/comps/9/2018-2019/defense/2018-2019-Premier-League-Stats"
"Miguel Britos","Watford",2019,"uy URU","DF",33,1985,2.1,4,2,4,0,0,2,4,50,2,1,1,0,3,7,11,1,"Matches","https://fbref.com/en/comps/9/2018-2019/defense/2018-2019-Premier-League-Stats"
"David Brooks","Bournemouth",2019,"wls WAL","MF,FW",21,1997,25.1,37,26,12,19,6,19,44,43.2,25,36,7,29,24,61,28,0,"Matches","https://fbref.com/en/comps/9/2018-2019/defense/2018-2019-Premier-League-Stats"
"Bruno","Brighton",2019,"es ESP","DF",37,1980,12.6,25,16,20,3,2,14,18,77.8,4,7,2,5,11,36,30,1,"Matches","https://fbref.com/en/comps/9/2018-2019/defense/2018-2019-Premier-League-Stats"
"Joe Bryan","Fulham",2019,"eng ENG","DF,MF",24,1993,26.1,61,41,35,21,5,24,42,57.1,18,34,12,22,31,92,82,1,"Matches","https://fbref.com/en/comps/9/2018-2019/defense/2018-2019-Premier-League-Stats"
"David Button","Brighton",2019,"eng ENG","GK",29,1989,4,0,0,0,0,0,0,0,NA,0,0,0,0,0,0,2,0,"Matches","https://fbref.com/en/comps/9/2018-2019/defense/2018-2019-Premier-League-Stats"
"Willy Caballero","Chelsea",2019,"ar ARG","GK",36,1981,2,0,0,0,0,0,0,0,NA,0,0,0,0,0,0,1,0,"Matches","https://fbref.com/en/comps/9/2018-2019/defense/2018-2019-Premier-League-Stats"
"Gary Cahill","Chelsea",2019,"eng ENG","DF",32,1985,0.3,0,0,0,0,0,0,0,NA,0,0,0,0,0,0,1,0,"Matches","https://fbref.com/en/comps/9/2018-2019/defense/2018-2019-Premier-League-Stats"
"Tom Cairney","Fulham",2019,"sct SCO","MF,FW",27,1991,24.4,37,21,9,22,6,12,16,75,4,21,5,16,10,47,13,1,"Matches","https://fbref.com/en/comps/9/2018-2019/defense/2018-2019-Premier-League-Stats"
"Dominic Calvert-Lewin","Everton",2019,"eng ENG","FW",21,1997,19.8,13,7,3,3,7,7,15,46.7,8,16,3,13,7,20,19,0,"Matches","https://fbref.com/en/comps/9/2018-2019/defense/2018-2019-Premier-League-Stats"
"Rafael Camacho","Liverpool",2019,"pt POR","DF",18,2000,0,1,0,1,0,0,1,1,100,0,0,0,0,0,1,0,0,"Matches","https://fbref.com/en/comps/9/2018-2019/defense/2018-2019-Premier-League-Stats"
"Víctor Camarasa","Cardiff City",2019,"es ESP","MF",24,1994,28.5,28,15,8,15,5,6,31,19.4,25,17,2,15,33,61,28,1,"Matches","https://fbref.com/en/comps/9/2018-2019/defense/2018-2019-Premier-League-Stats"
"Étienne Capoue","Watford",2019,"fr FRA","MF",30,1988,32.7,91,56,36,48,7,33,87,37.9,54,50,13,37,85,176,96,1,"Matches","https://fbref.com/en/comps/9/2018-2019/defense/2018-2019-Premier-League-Stats"
"Andy Carroll","West Ham",2019,"eng ENG","FW",29,1989,5.1,4,2,1,3,0,1,4,25,3,3,2,1,1,5,8,0,"Matches","https://fbref.com/en/comps/9/2018-2019/defense/2018-2019-Premier-League-Stats"
"Jonny Castro","Wolves",2019,"es ESP","DF,MF",24,1994,30.8,79,43,42,33,4,31,60,51.7,29,45,8,37,60,139,64,2,"Matches","https://fbref.com/en/comps/9/2018-2019/defense/2018-2019-Premier-League-Stats"
"Craig Cathcart","Watford",2019,"nir NIR","DF",29,1989,34.4,50,31,36,11,3,21,37,56.8,16,42,30,12,38,88,184,4,"Matches","https://fbref.com/en/comps/9/2018-2019/defense/2018-2019-Premier-League-Stats"
"Ivan Cavaleiro","Wolves",2019,"pt POR","FW,MF",24,1993,7.7,5,4,3,1,1,1,14,7.1,13,12,0,12,4,9,5,0,"Matches","https://fbref.com/en/comps/9/2018-2019/defense/2018-2019-Premier-League-Stats"
"Petr Cech","Arsenal",2019,"cz CZE","GK",36,1982,6.5,1,1,1,0,0,1,1,100,0,0,0,0,0,1,5,2,"Matches","https://fbref.com/en/comps/9/2018-2019/defense/2018-2019-Premier-League-Stats"
"Nathaniel Chalobah","Watford",2019,"eng ENG","MF",23,1994,3,3,2,1,2,0,2,7,28.6,5,2,1,1,5,8,7,0,"Matches","https://fbref.com/en/comps/9/2018-2019/defense/2018-2019-Premier-League-Stats"
"Calum Chambers","Fulham",2019,"eng ENG","MF,DF",23,1995,28.8,64,36,32,27,5,16,48,33.3,32,37,12,25,69,133,113,4,"Matches","https://fbref.com/en/comps/9/2018-2019/defense/2018-2019-Premier-League-Stats"
"Ben Chilwell","Leicester City",2019,"eng ENG","DF",21,1996,36,55,29,34,18,3,24,55,43.6,31,37,7,30,38,93,156,0,"Matches","https://fbref.com/en/comps/9/2018-2019/defense/2018-2019-Premier-League-Stats"
"Tahith Chong","Manchester Utd",2019,"nl NED","FW",18,1999,0.4,0,0,0,0,0,0,0,NA,0,1,0,1,0,0,1,0,"Matches","https://fbref.com/en/comps/9/2018-2019/defense/2018-2019-Premier-League-Stats"
"Hamza Choudhury","Leicester City",2019,"eng ENG","MF",20,1997,6.6,24,10,13,10,1,9,15,60,6,12,3,9,15,39,13,0,"Matches","https://fbref.com/en/comps/9/2018-2019/defense/2018-2019-Premier-League-Stats"
"Andreas Christensen","Chelsea",2019,"dk DEN","DF",22,1996,6.9,10,4,2,6,2,2,5,40,3,4,2,2,4,14,29,0,"Matches","https://fbref.com/en/comps/9/2018-2019/defense/2018-2019-Premier-League-Stats"
"Cyrus Christie","Fulham",2019,"ie IRL","DF,MF",25,1992,21.6,43,23,26,13,4,18,41,43.9,23,25,11,14,29,72,96,1,"Matches","https://fbref.com/en/comps/9/2018-2019/defense/2018-2019-Premier-League-Stats"
"Ibrahima Cissé","Fulham",2019,"gn GUI","MF",24,1994,1,0,0,0,0,0,0,1,0,1,0,0,0,3,3,4,0,"Matches","https://fbref.com/en/comps/9/2018-2019/defense/2018-2019-Premier-League-Stats"
"Ciaran Clark","Newcastle Utd",2019,"ie IRL","DF",28,1989,9.5,20,17,15,5,0,9,12,75,3,11,7,4,12,32,58,0,"Matches","https://fbref.com/en/comps/9/2018-2019/defense/2018-2019-Premier-League-Stats"
"Tom Cleverley","Watford",2019,"eng ENG","MF",28,1989,5.3,17,9,11,4,2,6,22,27.3,16,4,0,4,5,22,11,0,"Matches","https://fbref.com/en/comps/9/2018-2019/defense/2018-2019-Premier-League-Stats"
"Nathaniel Clyne","Bournemouth",2019,"eng ENG","DF",27,1991,12.7,33,18,16,14,3,11,23,47.8,12,13,3,10,16,49,33,1,"Matches","https://fbref.com/en/comps/9/2018-2019/defense/2018-2019-Premier-League-Stats"
"Nathaniel Clyne","Liverpool",2019,"eng ENG","DF",27,1991,1.2,4,3,2,2,0,2,4,50,2,1,0,1,2,6,1,0,"Matches","https://fbref.com/en/comps/9/2018-2019/defense/2018-2019-Premier-League-Stats"
"Conor Coady","Wolves",2019,"eng ENG","DF",25,1993,38,31,19,26,5,0,17,32,53.1,15,35,27,8,30,61,133,3,"Matches","https://fbref.com/en/comps/9/2018-2019/defense/2018-2019-Premier-League-Stats"
"Joel Coleman","Huddersfield",2019,"eng ENG","GK",22,1995,1,0,0,0,0,0,0,0,NA,0,0,0,0,0,0,0,0,"Matches","https://fbref.com/en/comps/9/2018-2019/defense/2018-2019-Premier-League-Stats"
"Séamus Coleman","Everton",2019,"ie IRL","DF",29,1988,28.4,44,25,23,18,3,19,30,63.3,11,14,5,9,26,70,86,0,"Matches","https://fbref.com/en/comps/9/2018-2019/defense/2018-2019-Premier-League-Stats"
"Lewis Cook","Bournemouth",2019,"eng ENG","MF",21,1997,8,13,6,6,7,0,8,19,42.1,11,8,2,6,8,21,7,1,"Matches","https://fbref.com/en/comps/9/2018-2019/defense/2018-2019-Premier-League-Stats"
"Steve Cook","Bournemouth",2019,"eng ENG","DF",27,1991,31,36,19,31,5,0,20,27,74.1,7,36,21,15,50,86,202,1,"Matches","https://fbref.com/en/comps/9/2018-2019/defense/2018-2019-Premier-League-Stats"
"Jack Cork","Burnley",2019,"eng ENG","MF",29,1989,36.8,51,27,12,34,5,18,46,39.1,28,39,16,23,29,80,82,2,"Matches","https://fbref.com/en/comps/9/2018-2019/defense/2018-2019-Premier-League-Stats"
"Hélder Costa","Wolves",2019,"ao ANG","FW,MF",24,1994,14.9,18,14,7,7,4,7,23,30.4,16,15,0,15,9,27,6,0,"Matches","https://fbref.com/en/comps/9/2018-2019/defense/2018-2019-Premier-League-Stats"
"Aaron Cresswell","West Ham",2019,"eng ENG","DF",28,1989,17.7,29,16,14,11,4,13,25,52,12,28,7,21,23,52,58,0,"Matches","https://fbref.com/en/comps/9/2018-2019/defense/2018-2019-Premier-League-Stats"
"Peter Crouch","Burnley",2019,"eng ENG","FW",37,1981,1,1,1,0,1,0,1,1,100,0,0,0,0,0,1,2,0,"Matches","https://fbref.com/en/comps/9/2018-2019/defense/2018-2019-Premier-League-Stats"
"Greg Cunningham","Cardiff City",2019,"ie IRL","DF",27,1991,7,18,7,11,4,3,9,16,56.3,7,9,3,6,17,35,16,1,"Matches","https://fbref.com/en/comps/9/2018-2019/defense/2018-2019-Premier-League-Stats"
"Diogo Dalot","Manchester Utd",2019,"pt POR","DF,FW",19,1999,11.3,24,12,8,14,2,14,19,73.7,5,15,2,13,10,34,35,1,"Matches","https://fbref.com/en/comps/9/2018-2019/defense/2018-2019-Premier-League-Stats"
"Matty Daly","Huddersfield",2019,"eng ENG","MF",17,2001,0.8,0,0,0,0,0,0,0,NA,0,0,0,0,0,0,0,0,"Matches","https://fbref.com/en/comps/9/2018-2019/defense/2018-2019-Premier-League-Stats"
"Loïc Damour","Cardiff City",2019,"fr FRA","MF",27,1991,0.3,0,0,0,0,0,0,1,0,1,0,0,0,0,0,0,0,"Matches","https://fbref.com/en/comps/9/2018-2019/defense/2018-2019-Premier-League-Stats"
"Charlie Daniels","Bournemouth",2019,"eng ENG","DF",31,1986,17.6,25,15,18,6,1,13,22,59.1,9,14,4,10,20,45,56,2,"Matches","https://fbref.com/en/comps/9/2018-2019/defense/2018-2019-Premier-League-Stats"
"Danilo","Manchester City",2019,"br BRA","DF",27,1991,9,20,16,6,12,2,12,17,70.6,5,5,0,5,15,35,22,1,"Matches","https://fbref.com/en/comps/9/2018-2019/defense/2018-2019-Premier-League-Stats"
"Scott Dann","Crystal Palace",2019,"eng ENG","DF",31,1987,7.4,6,2,5,1,0,3,7,42.9,4,16,12,4,5,11,46,0,"Matches","https://fbref.com/en/comps/9/2018-2019/defense/2018-2019-Premier-League-Stats"
"Matteo Darmian","Manchester Utd",2019,"it ITA","DF",28,1989,4.9,14,8,10,4,0,4,11,36.4,7,9,0,9,7,21,20,0,"Matches","https://fbref.com/en/comps/9/2018-2019/defense/2018-2019-Premier-League-Stats"
"Ben Davies","Tottenham",2019,"wls WAL","DF",25,1993,20.5,56,30,39,13,4,38,54,70.4,16,23,10,13,23,79,68,1,"Matches","https://fbref.com/en/comps/9/2018-2019/defense/2018-2019-Premier-League-Stats"
"Tom Davies","Everton",2019,"eng ENG","MF",20,1998,10.9,27,17,9,17,1,7,23,30.4,16,15,1,14,16,43,9,1,"Matches","https://fbref.com/en/comps/9/2018-2019/defense/2018-2019-Premier-League-Stats"
"Steven Davis","Southampton",2019,"nir NIR","MF",33,1985,1.1,2,2,0,2,0,0,0,NA,0,2,0,2,1,3,5,0,"Matches","https://fbref.com/en/comps/9/2018-2019/defense/2018-2019-Premier-League-Stats"
"Kevin De Bruyne","Manchester City",2019,"be BEL","MF",27,1991,10.8,22,15,6,12,4,7,21,33.3,14,13,1,12,3,25,2,1,"Matches","https://fbref.com/en/comps/9/2018-2019/defense/2018-2019-Premier-League-Stats"
"Troy Deeney","Watford",2019,"eng ENG","FW",30,1988,28.3,24,14,8,10,6,7,32,21.9,25,22,4,18,7,31,29,0,"Matches","https://fbref.com/en/comps/9/2018-2019/defense/2018-2019-Premier-League-Stats"
"Jermain Defoe","Bournemouth",2019,"eng ENG","FW",35,1982,0.3,0,0,0,0,0,0,0,NA,0,0,0,0,0,0,0,0,"Matches","https://fbref.com/en/comps/9/2018-2019/defense/2018-2019-Premier-League-Stats"
"Steven Defour","Burnley",2019,"be BEL","MF",30,1988,5,8,4,2,4,2,3,14,21.4,11,11,3,8,8,16,7,0,"Matches","https://fbref.com/en/comps/9/2018-2019/defense/2018-2019-Premier-League-Stats"
"Fabian Delph","Manchester City",2019,"eng ENG","DF",28,1989,8.1,23,14,11,7,5,12,23,52.2,11,3,0,3,13,36,19,1,"Matches","https://fbref.com/en/comps/9/2018-2019/defense/2018-2019-Premier-League-Stats"
"Mousa Dembélé","Tottenham",2019,"be BEL","MF",31,1987,5.7,13,9,6,6,1,4,7,57.1,3,4,1,3,7,20,5,2,"Matches","https://fbref.com/en/comps/9/2018-2019/defense/2018-2019-Premier-League-Stats"
"Leander Dendoncker","Wolves",2019,"be BEL","MF",23,1995,16.3,53,26,25,25,3,16,47,34,31,35,6,29,23,76,34,1,"Matches","https://fbref.com/en/comps/9/2018-2019/defense/2018-2019-Premier-League-Stats"
"Laurent Depoitre","Huddersfield",2019,"be BEL","FW",29,1988,11.9,6,4,2,3,1,0,3,0,3,9,0,9,2,8,8,0,"Matches","https://fbref.com/en/comps/9/2018-2019/defense/2018-2019-Premier-League-Stats"
"Gerard Deulofeu","Watford",2019,"es ESP","FW,MF",24,1994,23,11,6,5,3,3,4,26,15.4,22,16,0,16,14,25,3,0,"Matches","https://fbref.com/en/comps/9/2018-2019/defense/2018-2019-Premier-League-Stats"
"Fousseni Diabaté","Leicester City",2019,"ml MLI","FW",22,1995,0.6,2,0,2,0,0,0,1,0,1,2,0,2,0,2,0,0,"Matches","https://fbref.com/en/comps/9/2018-2019/defense/2018-2019-Premier-League-Stats"
"Adama Diakhaby","Huddersfield",2019,"fr FRA","FW,MF",22,1996,6.1,6,3,4,1,1,3,11,27.3,8,7,0,7,1,7,2,0,"Matches","https://fbref.com/en/comps/9/2018-2019/defense/2018-2019-Premier-League-Stats"
"Mohamed Diamé","Newcastle Utd",2019,"sn SEN","MF",31,1987,24.1,76,46,35,36,5,16,54,29.6,38,42,9,33,30,106,39,1,"Matches","https://fbref.com/en/comps/9/2018-2019/defense/2018-2019-Premier-League-Stats"
"Grady Diangana","West Ham",2019,"eng ENG","MF,FW",20,1998,6.8,20,9,8,8,4,5,14,35.7,9,11,0,11,1,21,4,0,"Matches","https://fbref.com/en/comps/9/2018-2019/defense/2018-2019-Premier-League-Stats"
"Eric Dier","Tottenham",2019,"eng ENG","MF,DF",24,1994,16.7,26,16,7,15,4,19,47,40.4,28,27,12,15,21,47,46,1,"Matches","https://fbref.com/en/comps/9/2018-2019/defense/2018-2019-Premier-League-Stats"
"Lucas Digne","Everton",2019,"fr FRA","DF",25,1993,32.9,71,46,45,18,8,28,45,62.2,17,43,9,34,60,131,116,0,"Matches","https://fbref.com/en/comps/9/2018-2019/defense/2018-2019-Premier-League-Stats"
"Issa Diop","West Ham",2019,"fr FRA","DF",21,1997,33,68,38,47,21,0,37,57,64.9,20,58,36,22,64,132,161,4,"Matches","https://fbref.com/en/comps/9/2018-2019/defense/2018-2019-Premier-League-Stats"
"Matt Doherty","Wolves",2019,"ie IRL","DF,MF",26,1992,34.9,67,42,48,15,4,35,58,60.3,23,49,7,42,60,127,107,2,"Matches","https://fbref.com/en/comps/9/2018-2019/defense/2018-2019-Premier-League-Stats"
"Abdoulaye Doucouré","Watford",2019,"ml MLI","MF",25,1993,34,71,38,27,32,12,19,57,33.3,38,31,8,23,34,105,55,5,"Matches","https://fbref.com/en/comps/9/2018-2019/defense/2018-2019-Premier-League-Stats"
"Luke Dreher","Crystal Palace",2019,"eng ENG","FW",19,1998,0,0,0,0,0,0,0,0,NA,0,0,0,0,0,0,0,0,"Matches","https://fbref.com/en/comps/9/2018-2019/defense/2018-2019-Premier-League-Stats"
"Martin Dúbravka","Newcastle Utd",2019,"sk SVK","GK",29,1989,38,2,0,2,0,0,1,3,33.3,2,0,0,0,0,2,20,5,"Matches","https://fbref.com/en/comps/9/2018-2019/defense/2018-2019-Premier-League-Stats"
"Shane Duffy","Brighton",2019,"ie IRL","DF",26,1992,34.3,35,20,23,7,5,14,25,56,11,57,47,10,36,71,244,3,"Matches","https://fbref.com/en/comps/9/2018-2019/defense/2018-2019-Premier-League-Stats"
"Demeaco Duhaney","Huddersfield",2019,"eng ENG","DF",19,1998,0.5,1,0,1,0,0,1,3,33.3,2,2,0,2,1,2,1,0,"Matches","https://fbref.com/en/comps/9/2018-2019/defense/2018-2019-Premier-League-Stats"
"Paul Dummett","Newcastle Utd",2019,"wls WAL","DF",26,1991,22.1,34,22,24,9,1,19,32,59.4,13,25,11,14,37,71,133,0,"Matches","https://fbref.com/en/comps/9/2018-2019/defense/2018-2019-Premier-League-Stats"
"Lewis Dunk","Brighton",2019,"eng ENG","DF",26,1991,35,42,26,31,10,1,17,39,43.6,22,49,38,11,46,88,196,5,"Matches","https://fbref.com/en/comps/9/2018-2019/defense/2018-2019-Premier-League-Stats"
"Erik Durm","Huddersfield",2019,"de GER","DF",26,1992,22.8,35,22,24,8,3,14,33,42.4,19,26,6,20,41,76,42,0,"Matches","https://fbref.com/en/comps/9/2018-2019/defense/2018-2019-Premier-League-Stats"
"Bruno Ecuele Manga","Cardiff City",2019,"ga GAB","DF",30,1988,37.5,69,36,48,16,5,29,58,50,29,62,28,34,81,150,179,4,"Matches","https://fbref.com/en/comps/9/2018-2019/defense/2018-2019-Premier-League-Stats"
"Ederson","Manchester City",2019,"br BRA","GK",24,1993,38,3,3,2,1,0,3,3,100,0,0,0,0,1,4,12,2,"Matches","https://fbref.com/en/comps/9/2018-2019/defense/2018-2019-Premier-League-Stats"
"Harvey Elliott","Fulham",2019,"eng ENG","MF",15,2003,0.2,0,0,0,0,0,0,0,NA,0,1,0,1,0,0,0,0,"Matches","https://fbref.com/en/comps/9/2018-2019/defense/2018-2019-Premier-League-Stats"
"Mohamed Elneny","Arsenal",2019,"eg EGY","MF",26,1992,4.2,13,4,9,1,3,1,2,50,1,7,4,3,2,15,8,0,"Matches","https://fbref.com/en/comps/9/2018-2019/defense/2018-2019-Premier-League-Stats"
"Mohamed Elyounoussi","Southampton",2019,"no NOR","MF",23,1994,8.8,16,12,7,6,3,6,19,31.6,13,11,1,10,6,22,5,0,"Matches","https://fbref.com/en/comps/9/2018-2019/defense/2018-2019-Premier-League-Stats"
"Christian Eriksen","Tottenham",2019,"dk DEN","MF",26,1992,30.8,41,25,8,20,13,17,59,28.8,42,26,3,23,15,56,13,0,"Matches","https://fbref.com/en/comps/9/2018-2019/defense/2018-2019-Premier-League-Stats"
"Neil Etheridge","Cardiff City",2019,"ph PHI","GK",28,1990,38,1,1,1,0,0,1,2,50,1,0,0,0,7,8,19,1,"Matches","https://fbref.com/en/comps/9/2018-2019/defense/2018-2019-Premier-League-Stats"
"Jonny Evans","Leicester City",2019,"nir NIR","DF",30,1988,22.2,24,13,20,4,0,13,18,72.2,5,28,10,18,33,57,152,3,"Matches","https://fbref.com/en/comps/9/2018-2019/defense/2018-2019-Premier-League-Stats"
"Lukasz Fabianski","West Ham",2019,"pl POL","GK",33,1985,38,1,0,1,0,0,1,3,33.3,2,0,0,0,1,2,10,1,"Matches","https://fbref.com/en/comps/9/2018-2019/defense/2018-2019-Premier-League-Stats"
"Fabinho","Liverpool",2019,"br BRA","MF",24,1993,22.4,59,31,17,38,4,24,59,40.7,35,34,6,28,28,87,27,2,"Matches","https://fbref.com/en/comps/9/2018-2019/defense/2018-2019-Premier-League-Stats"
"Cesc Fàbregas","Chelsea",2019,"es ESP","MF",31,1987,2,6,4,4,2,0,1,5,20,4,2,1,1,1,7,0,0,"Matches","https://fbref.com/en/comps/9/2018-2019/defense/2018-2019-Premier-League-Stats"
"Fabricio","Fulham",2019,"es ESP","GK",30,1987,2,1,1,1,0,0,0,0,NA,0,0,0,0,0,1,3,2,"Matches","https://fbref.com/en/comps/9/2018-2019/defense/2018-2019-Premier-League-Stats"
"Marouane Fellaini","Manchester Utd",2019,"be BEL","MF",30,1987,8.4,21,13,11,9,1,9,17,52.9,8,9,5,4,4,25,34,1,"Matches","https://fbref.com/en/comps/9/2018-2019/defense/2018-2019-Premier-League-Stats"
"Kiko Femenía","Watford",2019,"es ESP","DF",27,1991,22.8,48,30,34,12,2,24,51,47.1,27,24,6,18,36,84,68,0,"Matches","https://fbref.com/en/comps/9/2018-2019/defense/2018-2019-Premier-League-Stats"
"Federico Fernández","Newcastle Utd",2019,"ar ARG","DF",29,1989,16.5,16,12,12,4,0,10,18,55.6,8,19,12,7,25,41,106,1,"Matches","https://fbref.com/en/comps/9/2018-2019/defense/2018-2019-Premier-League-Stats"
"Fernandinho","Manchester City",2019,"br BRA","MF",33,1985,26.4,57,43,19,30,8,26,47,55.3,21,28,4,24,41,98,70,0,"Matches","https://fbref.com/en/comps/9/2018-2019/defense/2018-2019-Premier-League-Stats"
"Roberto Firmino","Liverpool",2019,"br BRA","FW,MF",26,1991,29,30,20,5,16,9,7,34,20.6,27,35,1,34,6,36,16,0,"Matches","https://fbref.com/en/comps/9/2018-2019/defense/2018-2019-Premier-League-Stats"
"Phil Foden","Manchester City",2019,"eng ENG","MF",18,2000,3.7,7,6,1,3,3,2,9,22.2,7,1,0,1,4,11,1,0,"Matches","https://fbref.com/en/comps/9/2018-2019/defense/2018-2019-Premier-League-Stats"
"Fraser Forster","Southampton",2019,"eng ENG","GK",30,1988,1,0,0,0,0,0,0,0,NA,0,0,0,0,0,0,1,0,"Matches","https://fbref.com/en/comps/9/2018-2019/defense/2018-2019-Premier-League-Stats"
"Ben Foster","Watford",2019,"eng ENG","GK",35,1983,38,2,2,2,0,0,2,6,33.3,4,0,0,0,2,4,34,3,"Matches","https://fbref.com/en/comps/9/2018-2019/defense/2018-2019-Premier-League-Stats"
"Timothy Fosu-Mensah","Fulham",2019,"nl NED","DF",20,1998,8.8,18,7,12,6,0,8,13,61.5,5,11,5,6,12,30,30,1,"Matches","https://fbref.com/en/comps/9/2018-2019/defense/2018-2019-Premier-League-Stats"
"Juan Foyth","Tottenham",2019,"ar ARG","DF",20,1998,9.9,31,17,20,11,0,14,19,73.7,5,12,5,7,10,41,50,1,"Matches","https://fbref.com/en/comps/9/2018-2019/defense/2018-2019-Premier-League-Stats"
"Simon Francis","Bournemouth",2019,"eng ENG","DF",33,1985,13.7,25,14,19,5,1,12,24,50,12,15,7,8,19,44,73,1,"Matches","https://fbref.com/en/comps/9/2018-2019/defense/2018-2019-Premier-League-Stats"
"Ryan Fraser","Bournemouth",2019,"sct SCO","MF,FW",24,1994,35.2,19,11,9,8,2,10,32,31.3,22,23,6,17,22,41,33,0,"Matches","https://fbref.com/en/comps/9/2018-2019/defense/2018-2019-Premier-League-Stats"
"Fred","Manchester Utd",2019,"br BRA","MF",25,1993,11.6,29,17,12,16,1,15,33,45.5,18,26,2,24,16,45,14,2,"Matches","https://fbref.com/en/comps/9/2018-2019/defense/2018-2019-Premier-League-Stats"
"Ryan Fredericks","West Ham",2019,"eng ENG","DF",25,1992,12.1,38,23,33,5,0,21,32,65.6,11,15,5,10,13,51,49,1,"Matches","https://fbref.com/en/comps/9/2018-2019/defense/2018-2019-Premier-League-Stats"
"Christian Fuchs","Leicester City",2019,"at AUT","DF",32,1986,2.3,4,3,0,4,0,1,2,50,1,0,0,0,4,8,8,0,"Matches","https://fbref.com/en/comps/9/2018-2019/defense/2018-2019-Premier-League-Stats"
"Manolo Gabbiadini","Southampton",2019,"it ITA","FW,MF",26,1991,5.3,6,2,1,4,1,1,2,50,1,5,0,5,3,9,6,0,"Matches","https://fbref.com/en/comps/9/2018-2019/defense/2018-2019-Premier-League-Stats"
"Sam Gallagher","Southampton",2019,"eng ENG","FW",22,1995,0.4,0,0,0,0,0,0,0,NA,0,1,0,1,0,0,1,0,"Matches","https://fbref.com/en/comps/9/2018-2019/defense/2018-2019-Premier-League-Stats"
"Idrissa Gana Gueye","Everton",2019,"sn SEN","MF",28,1989,31.4,142,89,70,63,9,38,76,50,38,52,8,44,74,216,48,1,"Matches","https://fbref.com/en/comps/9/2018-2019/defense/2018-2019-Premier-League-Stats"
"James Garner","Manchester Utd",2019,"eng ENG","MF",17,2001,0,0,0,0,0,0,0,0,NA,0,0,0,0,0,0,0,0,"Matches","https://fbref.com/en/comps/9/2018-2019/defense/2018-2019-Premier-League-Stats"
"Paulo Gazzaniga","Tottenham",2019,"ar ARG","GK",26,1992,3,0,0,0,0,0,0,0,NA,0,0,0,0,0,0,1,0,"Matches","https://fbref.com/en/comps/9/2018-2019/defense/2018-2019-Premier-League-Stats"
"David de Gea","Manchester Utd",2019,"es ESP","GK",27,1990,38,0,0,0,0,0,0,2,0,2,1,0,1,0,0,11,4,"Matches","https://fbref.com/en/comps/9/2018-2019/defense/2018-2019-Premier-League-Stats"
"Rachid Ghezzal","Leicester City",2019,"dz ALG","FW,MF",26,1992,8.3,14,5,3,7,4,3,18,16.7,15,10,1,9,7,21,4,1,"Matches","https://fbref.com/en/comps/9/2018-2019/defense/2018-2019-Premier-League-Stats"
"Morgan Gibbs-White","Wolves",2019,"eng ENG","MF,FW",18,2000,7.4,6,3,2,4,0,1,4,25,3,6,0,6,1,7,0,0,"Matches","https://fbref.com/en/comps/9/2018-2019/defense/2018-2019-Premier-League-Stats"
"Ben Gibson","Burnley",2019,"eng ENG","DF",25,1993,0.7,1,1,1,0,0,0,0,NA,0,1,1,0,0,1,2,0,"Matches","https://fbref.com/en/comps/9/2018-2019/defense/2018-2019-Premier-League-Stats"
"Olivier Giroud","Chelsea",2019,"fr FRA","FW",31,1986,9.4,3,2,0,1,2,1,4,25,3,6,1,5,3,6,7,0,"Matches","https://fbref.com/en/comps/9/2018-2019/defense/2018-2019-Premier-League-Stats"
"André Gomes","Everton",2019,"pt POR","MF",25,1993,22,39,23,12,24,3,13,59,22,46,27,4,23,20,59,18,0,"Matches","https://fbref.com/en/comps/9/2018-2019/defense/2018-2019-Premier-League-Stats"
"Angel Gomes","Manchester Utd",2019,"eng ENG","MF,FW",17,2000,0.3,1,0,0,0,1,0,0,NA,0,0,0,0,0,1,0,0,"Matches","https://fbref.com/en/comps/9/2018-2019/defense/2018-2019-Premier-League-Stats"
"Joe Gomez","Liverpool",2019,"eng ENG","DF",21,1997,11.8,18,11,10,7,1,9,15,60,6,10,5,5,14,32,42,0,"Matches","https://fbref.com/en/comps/9/2018-2019/defense/2018-2019-Premier-League-Stats"
"Jon Gorenc Stankovic","Huddersfield",2019,"si SVN","MF,DF",22,1996,7.9,26,18,18,7,1,14,26,53.8,12,16,9,7,9,35,20,1,"Matches","https://fbref.com/en/comps/9/2018-2019/defense/2018-2019-Premier-League-Stats"
"Dan Gosling","Bournemouth",2019,"eng ENG","MF",28,1990,19.3,57,23,27,21,9,28,53,52.8,25,33,11,22,20,77,46,1,"Matches","https://fbref.com/en/comps/9/2018-2019/defense/2018-2019-Premier-League-Stats"
"Karlan Grant","Huddersfield",2019,"eng ENG","FW",20,1997,9.7,5,2,1,2,2,1,3,33.3,2,8,0,8,2,7,1,1,"Matches","https://fbref.com/en/comps/9/2018-2019/defense/2018-2019-Premier-League-Stats"
"Andre Gray","Watford",2019,"jm JAM","FW",27,1991,15.2,3,1,0,2,1,1,6,16.7,5,3,1,2,2,5,6,0,"Matches","https://fbref.com/en/comps/9/2018-2019/defense/2018-2019-Premier-League-Stats"
"Demarai Gray","Leicester City",2019,"eng ENG","FW,MF",22,1996,22.1,25,12,7,14,4,6,16,37.5,10,19,0,19,9,34,15,0,"Matches","https://fbref.com/en/comps/9/2018-2019/defense/2018-2019-Premier-League-Stats"
"Mason Greenwood","Manchester Utd",2019,"eng ENG","FW",16,2001,1.3,3,3,2,0,1,2,3,66.7,1,2,0,2,0,3,1,0,"Matches","https://fbref.com/en/comps/9/2018-2019/defense/2018-2019-Premier-League-Stats"
"Pascal Groß","Brighton",2019,"de GER","MF,FW",27,1991,20.7,27,12,12,12,3,11,36,30.6,25,20,8,12,13,40,23,0,"Matches","https://fbref.com/en/comps/9/2018-2019/defense/2018-2019-Premier-League-Stats"
"Vicente Guaita","Crystal Palace",2019,"es ESP","GK",31,1987,19.5,0,0,0,0,0,0,0,NA,0,0,0,0,0,0,5,2,"Matches","https://fbref.com/en/comps/9/2018-2019/defense/2018-2019-Premier-League-Stats"
"Mattéo Guendouzi","Arsenal",2019,"fr FRA","MF",19,1999,23.9,44,26,18,23,3,17,47,36.2,30,28,5,23,30,74,24,3,"Matches","https://fbref.com/en/comps/9/2018-2019/defense/2018-2019-Premier-League-Stats"
"Ilkay Gündogan","Manchester City",2019,"de GER","MF",27,1990,23.7,19,12,4,12,3,6,31,19.4,25,12,3,9,28,47,19,1,"Matches","https://fbref.com/en/comps/9/2018-2019/defense/2018-2019-Premier-League-Stats"
"Angus Gunn","Southampton",2019,"sct SCO","GK",22,1996,12,0,0,0,0,0,0,0,NA,0,0,0,0,0,0,8,3,"Matches","https://fbref.com/en/comps/9/2018-2019/defense/2018-2019-Premier-League-Stats"
"Aron Gunnarsson","Cardiff City",2019,"is ISL","MF",29,1989,25.2,51,29,23,25,3,23,84,27.4,61,40,12,28,38,89,55,1,"Matches","https://fbref.com/en/comps/9/2018-2019/defense/2018-2019-Premier-League-Stats"
"Florent Hadergjonaj","Huddersfield",2019,"xk KVX","DF,MF",24,1994,20.5,30,17,10,18,2,13,37,35.1,24,21,7,14,21,51,37,1,"Matches","https://fbref.com/en/comps/9/2018-2019/defense/2018-2019-Premier-League-Stats"
"Ben Hamer","Huddersfield",2019,"eng ENG","GK",30,1987,6.1,0,0,0,0,0,0,3,0,3,0,0,0,1,1,3,2,"Matches","https://fbref.com/en/comps/9/2018-2019/defense/2018-2019-Premier-League-Stats"
"Kadeem Harris","Cardiff City",2019,"eng ENG","MF",25,1993,4.2,12,5,6,4,2,7,8,87.5,1,3,0,3,3,15,5,0,"Matches","https://fbref.com/en/comps/9/2018-2019/defense/2018-2019-Premier-League-Stats"
"Joe Hart","Burnley",2019,"eng ENG","GK",31,1987,19,0,0,0,0,0,0,1,0,1,0,0,0,0,0,11,3,"Matches","https://fbref.com/en/comps/9/2018-2019/defense/2018-2019-Premier-League-Stats"
"Isaac Hayden","Newcastle Utd",2019,"eng ENG","MF",23,1995,20.7,73,43,19,45,9,23,41,56.1,18,32,4,28,40,113,30,0,"Matches","https://fbref.com/en/comps/9/2018-2019/defense/2018-2019-Premier-League-Stats"
"Eden Hazard","Chelsea",2019,"be BEL","FW",27,1991,32.5,14,9,2,1,11,5,17,29.4,12,10,0,10,13,27,6,1,"Matches","https://fbref.com/en/comps/9/2018-2019/defense/2018-2019-Premier-League-Stats"
"Rhys Healey","Cardiff City",2019,"wls WAL","FW",23,1994,0.6,1,0,0,1,0,0,1,0,1,0,0,0,0,1,0,0,"Matches","https://fbref.com/en/comps/9/2018-2019/defense/2018-2019-Premier-League-Stats"
"Tom Heaton","Burnley",2019,"eng ENG","GK",32,1986,19,0,0,0,0,0,0,2,0,2,0,0,0,0,0,8,2,"Matches","https://fbref.com/en/comps/9/2018-2019/defense/2018-2019-Premier-League-Stats"
"Jordan Henderson","Liverpool",2019,"eng ENG","MF",28,1990,22.1,46,36,20,22,4,16,39,41,23,27,3,24,30,76,17,0,"Matches","https://fbref.com/en/comps/9/2018-2019/defense/2018-2019-Premier-League-Stats"
"Jeff Hendrick","Burnley",2019,"ie IRL","MF,FW",26,1992,22.9,24,12,13,7,4,9,32,28.1,23,20,5,15,12,36,31,0,"Matches","https://fbref.com/en/comps/9/2018-2019/defense/2018-2019-Premier-League-Stats"
"Wayne Hennessey","Crystal Palace",2019,"wls WAL","GK",31,1987,17.5,0,0,0,0,0,0,2,0,2,0,0,0,0,0,5,1,"Matches","https://fbref.com/en/comps/9/2018-2019/defense/2018-2019-Premier-League-Stats"
"Javier Hernández","West Ham",2019,"mx MEX","FW",30,1988,14.8,3,0,0,3,0,0,6,0,6,8,1,7,1,4,8,0,"Matches","https://fbref.com/en/comps/9/2018-2019/defense/2018-2019-Premier-League-Stats"
"Ander Herrera","Manchester Utd",2019,"es ESP","MF",28,1989,15.6,54,28,24,22,8,21,61,34.4,40,38,6,32,37,91,25,1,"Matches","https://fbref.com/en/comps/9/2018-2019/defense/2018-2019-Premier-League-Stats"
"Son Heung-min","Tottenham",2019,"kr KOR","FW,MF",26,1992,22.7,23,12,7,12,4,10,34,29.4,24,26,2,24,8,31,4,1,"Matches","https://fbref.com/en/comps/9/2018-2019/defense/2018-2019-Premier-League-Stats"
"Gonzalo Higuaín","Chelsea",2019,"ar ARG","FW",30,1987,12.1,10,7,2,4,4,2,11,18.2,9,4,0,4,1,11,5,0,"Matches","https://fbref.com/en/comps/9/2018-2019/defense/2018-2019-Premier-League-Stats"
"Wesley Hoedt","Southampton",2019,"nl NED","DF",24,1994,13,28,12,23,5,0,17,26,65.4,9,20,13,7,23,51,79,2,"Matches","https://fbref.com/en/comps/9/2018-2019/defense/2018-2019-Premier-League-Stats"
"Jonathan Hogg","Huddersfield",2019,"eng ENG","MF",29,1988,26.3,78,41,18,51,9,27,69,39.1,42,46,7,39,73,151,19,1,"Matches","https://fbref.com/en/comps/9/2018-2019/defense/2018-2019-Premier-League-Stats"
"Junior Hoilett","Cardiff City",2019,"ca CAN","MF,FW",28,1990,23.8,40,27,26,11,3,15,53,28.3,38,34,0,34,32,72,30,0,"Matches","https://fbref.com/en/comps/9/2018-2019/defense/2018-2019-Premier-League-Stats"
"Rob Holding","Arsenal",2019,"eng ENG","DF",22,1995,9,11,7,9,2,0,2,8,25,6,9,7,2,12,23,40,0,"Matches","https://fbref.com/en/comps/9/2018-2019/defense/2018-2019-Premier-League-Stats"
"José Holebas","Watford",2019,"gr GRE","DF",34,1984,26.6,68,40,44,20,4,28,53,52.8,25,27,8,19,21,89,97,0,"Matches","https://fbref.com/en/comps/9/2018-2019/defense/2018-2019-Premier-League-Stats"
"Mason Holgate","Everton",2019,"eng ENG","DF",21,1996,4.5,5,4,4,1,0,1,1,100,0,3,2,1,3,8,32,0,"Matches","https://fbref.com/en/comps/9/2018-2019/defense/2018-2019-Premier-League-Stats"
"Callum Hudson-Odoi","Chelsea",2019,"eng ENG","FW",17,2000,4.4,8,6,8,0,0,2,4,50,2,1,0,1,3,11,0,0,"Matches","https://fbref.com/en/comps/9/2018-2019/defense/2018-2019-Premier-League-Stats"
"Will Hughes","Watford",2019,"eng ENG","MF",23,1995,26.9,74,43,27,35,12,25,59,42.4,34,55,6,49,25,99,30,0,"Matches","https://fbref.com/en/comps/9/2018-2019/defense/2018-2019-Premier-League-Stats"
"Emerson Hyndman","Bournemouth",2019,"us USA","MF",22,1996,0.4,6,2,6,0,0,2,3,66.7,1,0,0,0,1,7,0,0,"Matches","https://fbref.com/en/comps/9/2018-2019/defense/2018-2019-Premier-League-Stats"
"Pierre Højbjerg","Southampton",2019,"dk DEN","MF",22,1995,30.7,71,49,20,44,7,24,73,32.9,49,51,8,43,60,131,30,1,"Matches","https://fbref.com/en/comps/9/2018-2019/defense/2018-2019-Premier-League-Stats"
"Jordon Ibe","Bournemouth",2019,"eng ENG","MF,DF",22,1995,8.9,6,5,0,5,1,2,7,28.6,5,2,0,2,4,10,4,0,"Matches","https://fbref.com/en/comps/9/2018-2019/defense/2018-2019-Premier-League-Stats"
"Vicente Iborra","Leicester City",2019,"es ESP","MF",30,1988,2.5,4,1,1,3,0,0,7,0,7,1,0,1,8,12,4,1,"Matches","https://fbref.com/en/comps/9/2018-2019/defense/2018-2019-Premier-League-Stats"
"Kelechi Iheanacho","Leicester City",2019,"ng NGA","FW,MF",21,1996,10.5,6,5,4,1,1,1,5,20,4,5,0,5,2,8,3,0,"Matches","https://fbref.com/en/comps/9/2018-2019/defense/2018-2019-Premier-League-Stats"
"Danny Ings","Southampton",2019,"eng ENG","FW",26,1992,18.3,30,14,5,19,6,11,28,39.3,17,30,2,28,5,35,9,0,"Matches","https://fbref.com/en/comps/9/2018-2019/defense/2018-2019-Premier-League-Stats"
"Alex Iwobi","Arsenal",2019,"ng NGA","FW,MF",22,1996,21.9,28,14,10,16,2,6,25,24,19,21,1,20,12,40,13,1,"Matches","https://fbref.com/en/comps/9/2018-2019/defense/2018-2019-Premier-League-Stats"
"José Izquierdo","Brighton",2019,"co COL","MF,FW",26,1992,8.8,15,9,9,4,2,10,20,50,10,7,1,6,5,20,7,0,"Matches","https://fbref.com/en/comps/9/2018-2019/defense/2018-2019-Premier-League-Stats"
"Phil Jagielka","Everton",2019,"eng ENG","DF",35,1982,3.7,7,5,3,4,0,1,4,25,3,1,0,1,2,9,14,0,"Matches","https://fbref.com/en/comps/9/2018-2019/defense/2018-2019-Premier-League-Stats"
"Alireza Jahanbakhsh","Brighton",2019,"ir IRN","FW,MF",24,1993,11.3,32,18,17,11,4,11,30,36.7,19,16,0,16,11,43,4,0,"Matches","https://fbref.com/en/comps/9/2018-2019/defense/2018-2019-Premier-League-Stats"
"Daryl Janmaat","Watford",2019,"nl NED","DF",29,1989,16.9,36,24,23,11,2,20,29,69,9,16,6,10,33,69,71,0,"Matches","https://fbref.com/en/comps/9/2018-2019/defense/2018-2019-Premier-League-Stats"
"Vincent Janssen","Tottenham",2019,"nl NED","FW",24,1994,0.4,2,1,0,2,0,0,0,NA,0,0,0,0,0,2,1,0,"Matches","https://fbref.com/en/comps/9/2018-2019/defense/2018-2019-Premier-League-Stats"
"Carl Jenkinson","Arsenal",2019,"eng ENG","DF",26,1992,1.8,3,2,2,0,1,2,3,66.7,1,4,3,1,0,3,2,0,"Matches","https://fbref.com/en/comps/9/2018-2019/defense/2018-2019-Premier-League-Stats"
"Gabriel Jesus","Manchester City",2019,"br BRA","FW",21,1997,11.5,10,3,5,2,3,0,5,0,5,16,2,14,3,13,4,0,"Matches","https://fbref.com/en/comps/9/2018-2019/defense/2018-2019-Premier-League-Stats"
"Raúl Jiménez","Wolves",2019,"mx MEX","FW",27,1991,34.6,30,18,5,17,8,6,23,26.1,17,25,3,22,26,56,40,0,"Matches","https://fbref.com/en/comps/9/2018-2019/defense/2018-2019-Premier-League-Stats"
"Stefan Johansen","Fulham",2019,"no NOR","MF",27,1991,4.6,11,3,4,7,0,5,8,62.5,3,5,0,5,3,14,6,0,"Matches","https://fbref.com/en/comps/9/2018-2019/defense/2018-2019-Premier-League-Stats"
"Ben Johnson","West Ham",2019,"eng ENG","DF",18,2000,0.7,1,0,1,0,0,0,1,0,1,0,0,0,1,2,5,0,"Matches","https://fbref.com/en/comps/9/2018-2019/defense/2018-2019-Premier-League-Stats"
"Tyreke Johnson","Southampton",2019,"eng ENG","MF",19,1998,0,0,0,0,0,0,0,0,NA,0,0,0,0,0,0,0,0,"Matches","https://fbref.com/en/comps/9/2018-2019/defense/2018-2019-Premier-League-Stats"
"Phil Jones","Manchester Utd",2019,"eng ENG","DF",26,1992,14,19,13,12,7,0,8,13,61.5,5,16,11,5,23,42,67,3,"Matches","https://fbref.com/en/comps/9/2018-2019/defense/2018-2019-Premier-League-Stats"
"Jorginho","Chelsea",2019,"it ITA","MF",26,1991,35.1,76,38,27,41,8,45,96,46.9,51,46,7,39,64,140,38,1,"Matches","https://fbref.com/en/comps/9/2018-2019/defense/2018-2019-Premier-League-Stats"
"Joselu","Newcastle Utd",2019,"es ESP","FW",28,1990,6.6,14,8,4,5,5,4,9,44.4,5,5,0,5,3,17,15,0,"Matches","https://fbref.com/en/comps/9/2018-2019/defense/2018-2019-Premier-League-Stats"
"Diogo Jota","Wolves",2019,"pt POR","FW,MF",21,1996,26.2,28,16,11,11,6,10,38,26.3,28,20,1,19,13,41,11,0,"Matches","https://fbref.com/en/comps/9/2018-2019/defense/2018-2019-Premier-League-Stats"
"Mathias Jørgensen","Huddersfield",2019,"dk DEN","DF",28,1990,23.9,49,31,27,21,1,27,46,58.7,19,29,14,15,69,118,83,0,"Matches","https://fbref.com/en/comps/9/2018-2019/defense/2018-2019-Premier-League-Stats"
"Christian Kabasele","Watford",2019,"be BEL","DF",27,1991,17.6,25,14,20,5,0,10,23,43.5,13,21,16,5,38,63,111,0,"Matches","https://fbref.com/en/comps/9/2018-2019/defense/2018-2019-Premier-League-Stats"
"Elias Kachunga","Huddersfield",2019,"cd COD","FW,MF",26,1992,13.1,22,9,8,12,2,9,25,36,16,16,1,15,4,26,10,0,"Matches","https://fbref.com/en/comps/9/2018-2019/defense/2018-2019-Premier-League-Stats"
"Aboubakar Kamara","Fulham",2019,"mr MTN","FW",23,1995,7.7,8,4,1,5,2,3,7,42.9,4,6,0,6,1,9,6,0,"Matches","https://fbref.com/en/comps/9/2018-2019/defense/2018-2019-Premier-League-Stats"
"Harry Kane","Tottenham",2019,"eng ENG","FW",25,1993,26.9,10,6,2,8,0,1,14,7.1,13,16,6,10,1,11,14,0,"Matches","https://fbref.com/en/comps/9/2018-2019/defense/2018-2019-Premier-League-Stats"
"N'Golo Kanté","Chelsea",2019,"fr FRA","MF",27,1991,34.4,75,41,21,41,13,23,67,34.3,44,63,6,57,44,119,32,1,"Matches","https://fbref.com/en/comps/9/2018-2019/defense/2018-2019-Premier-League-Stats"
"Beram Kayal","Brighton",2019,"il ISR","MF",30,1988,10.4,28,17,16,11,1,5,21,23.8,16,17,10,7,15,43,25,0,"Matches","https://fbref.com/en/comps/9/2018-2019/defense/2018-2019-Premier-League-Stats"
"Michael Keane","Everton",2019,"eng ENG","DF",25,1993,33,41,25,22,16,3,19,32,59.4,13,30,22,8,43,84,185,4,"Matches","https://fbref.com/en/comps/9/2018-2019/defense/2018-2019-Premier-League-Stats"
"Neeskens Kebano","Fulham",2019,"cd COD","FW,MF",26,1992,1.2,3,1,2,1,0,1,1,100,0,3,0,3,0,3,3,0,"Matches","https://fbref.com/en/comps/9/2018-2019/defense/2018-2019-Premier-League-Stats"
"Naby Keïta","Liverpool",2019,"gn GUI","MF,FW",23,1995,15.4,37,15,13,19,5,14,42,33.3,28,29,4,25,12,49,16,1,"Matches","https://fbref.com/en/comps/9/2018-2019/defense/2018-2019-Premier-League-Stats"
"Martin Kelly","Crystal Palace",2019,"eng ENG","DF",28,1990,12.3,21,13,18,2,1,14,19,73.7,5,18,12,6,11,32,88,1,"Matches","https://fbref.com/en/comps/9/2018-2019/defense/2018-2019-Premier-League-Stats"
"Kenedy","Newcastle Utd",2019,"br BRA","MF,DF",22,1996,15,30,22,11,16,3,12,29,41.4,17,10,0,10,32,62,24,1,"Matches","https://fbref.com/en/comps/9/2018-2019/defense/2018-2019-Premier-League-Stats"
"Jonjoe Kenny","Everton",2019,"eng ENG","DF",21,1997,8.8,21,16,16,4,1,10,18,55.6,8,13,2,11,17,38,36,1,"Matches","https://fbref.com/en/comps/9/2018-2019/defense/2018-2019-Premier-League-Stats"
"Max Kilman","Wolves",2019,"eng ENG","DF",21,1997,0,0,0,0,0,0,0,0,NA,0,0,0,0,0,0,0,0,"Matches","https://fbref.com/en/comps/9/2018-2019/defense/2018-2019-Premier-League-Stats"
"Joshua King","Bournemouth",2019,"no NOR","FW,MF",26,1992,32.9,30,19,7,19,4,8,29,27.6,21,28,4,24,7,37,14,0,"Matches","https://fbref.com/en/comps/9/2018-2019/defense/2018-2019-Premier-League-Stats"
"Anthony Knockaert","Brighton",2019,"fr FRA","MF,FW",26,1991,20.4,33,21,12,15,6,13,30,43.3,17,13,0,13,29,62,11,0,"Matches","https://fbref.com/en/comps/9/2018-2019/defense/2018-2019-Premier-League-Stats"
"Sead Kolainac","Arsenal",2019,"ba BIH","DF,MF",25,1993,21,34,21,21,7,6,20,34,58.8,14,12,3,9,20,54,28,3,"Matches","https://fbref.com/en/comps/9/2018-2019/defense/2018-2019-Premier-League-Stats"
"Vincent Kompany","Manchester City",2019,"be BEL","DF",32,1986,13.6,16,10,11,3,2,8,9,88.9,1,11,8,3,16,32,55,0,"Matches","https://fbref.com/en/comps/9/2018-2019/defense/2018-2019-Premier-League-Stats"
"Terence Kongolo","Huddersfield",2019,"nl NED","DF",24,1994,30.2,74,46,44,26,4,27,47,57.4,20,42,16,26,65,139,106,1,"Matches","https://fbref.com/en/comps/9/2018-2019/defense/2018-2019-Premier-League-Stats"
"Laurent Koscielny","Arsenal",2019,"fr FRA","DF",32,1985,14.8,19,11,9,9,1,10,16,62.5,6,20,15,5,30,49,72,0,"Matches","https://fbref.com/en/comps/9/2018-2019/defense/2018-2019-Premier-League-Stats"
"Cheikhou Kouyaté","Crystal Palace",2019,"sn SEN","MF",28,1989,21.1,59,33,23,31,5,9,33,27.3,24,29,11,18,16,75,33,0,"Matches","https://fbref.com/en/comps/9/2018-2019/defense/2018-2019-Premier-League-Stats"
"Mateo Kovacic","Chelsea",2019,"hr CRO","MF",24,1994,19.3,45,29,23,19,3,20,46,43.5,26,19,2,17,8,53,18,1,"Matches","https://fbref.com/en/comps/9/2018-2019/defense/2018-2019-Premier-League-Stats"
"Rajiv van La Parra","Huddersfield",2019,"nl NED","FW,MF",27,1991,4.5,8,5,1,7,0,1,6,16.7,5,0,0,0,4,12,3,1,"Matches","https://fbref.com/en/comps/9/2018-2019/defense/2018-2019-Premier-League-Stats"
"Alexandre Lacazette","Arsenal",2019,"fr FRA","FW",27,1991,27.8,35,16,6,19,10,5,28,17.9,23,27,1,26,15,50,31,0,"Matches","https://fbref.com/en/comps/9/2018-2019/defense/2018-2019-Premier-League-Stats"
"Adam Lallana","Liverpool",2019,"eng ENG","MF,FW",30,1988,5.2,16,9,6,7,3,5,12,41.7,7,10,1,9,5,21,4,0,"Matches","https://fbref.com/en/comps/9/2018-2019/defense/2018-2019-Premier-League-Stats"
"Érik Lamela","Tottenham",2019,"ar ARG","MF,FW",26,1992,10.8,17,13,6,7,4,5,14,35.7,9,14,0,14,7,24,1,0,"Matches","https://fbref.com/en/comps/9/2018-2019/defense/2018-2019-Premier-League-Stats"
"Manuel Lanzini","West Ham",2019,"ar ARG","MF",25,1993,7.6,12,7,5,6,1,5,18,27.8,13,3,1,2,9,21,7,1,"Matches","https://fbref.com/en/comps/9/2018-2019/defense/2018-2019-Premier-League-Stats"
"Aymeric Laporte","Manchester City",2019,"es ESP","DF",24,1994,34,42,20,27,14,1,22,34,64.7,12,16,9,7,39,81,98,2,"Matches","https://fbref.com/en/comps/9/2018-2019/defense/2018-2019-Premier-League-Stats"
"Jamaal Lascelles","Newcastle Utd",2019,"eng ENG","DF",24,1993,30.5,32,21,25,5,2,11,14,78.6,3,43,28,15,39,71,218,3,"Matches","https://fbref.com/en/comps/9/2018-2019/defense/2018-2019-Premier-League-Stats"
"Maxime Le Marchand","Fulham",2019,"fr FRA","DF",28,1989,25,56,36,45,11,0,23,47,48.9,24,30,16,14,54,110,129,2,"Matches","https://fbref.com/en/comps/9/2018-2019/defense/2018-2019-Premier-League-Stats"
"Florian Lejeune","Newcastle Utd",2019,"fr FRA","DF",27,1991,11.7,25,15,17,7,1,11,24,45.8,13,16,5,11,21,46,49,0,"Matches","https://fbref.com/en/comps/9/2018-2019/defense/2018-2019-Premier-League-Stats"
"Mario Lemina","Southampton",2019,"ga GAB","MF",24,1993,17.9,49,32,23,23,3,15,34,44.1,19,27,3,24,43,92,31,1,"Matches","https://fbref.com/en/comps/9/2018-2019/defense/2018-2019-Premier-League-Stats"
"Aaron Lennon","Burnley",2019,"eng ENG","MF",31,1987,13.5,26,16,11,12,3,6,14,42.9,8,24,0,24,10,36,18,0,"Matches","https://fbref.com/en/comps/9/2018-2019/defense/2018-2019-Premier-League-Stats"
"Bernd Leno","Arsenal",2019,"de GER","GK",26,1992,31.5,0,0,0,0,0,0,3,0,3,0,0,0,4,4,16,6,"Matches","https://fbref.com/en/comps/9/2018-2019/defense/2018-2019-Premier-League-Stats"
"Jefferson Lerma","Bournemouth",2019,"co COL","MF",23,1994,27.8,45,31,20,20,5,14,54,25.9,40,35,19,16,54,99,88,1,"Matches","https://fbref.com/en/comps/9/2018-2019/defense/2018-2019-Premier-League-Stats"
"Stephan Lichtsteiner","Arsenal",2019,"ch SUI","DF",34,1984,10.4,15,9,5,4,6,9,16,56.3,7,11,4,7,9,24,25,1,"Matches","https://fbref.com/en/comps/9/2018-2019/defense/2018-2019-Premier-League-Stats"
"Victor Lindelöf","Manchester Utd",2019,"se SWE","DF",24,1994,28.9,40,27,28,12,0,13,23,56.5,10,21,12,9,24,64,121,3,"Matches","https://fbref.com/en/comps/9/2018-2019/defense/2018-2019-Premier-League-Stats"
"Jesse Lingard","Manchester Utd",2019,"eng ENG","FW,MF",25,1992,18.5,29,18,8,11,10,7,28,25,21,18,2,16,10,39,9,1,"Matches","https://fbref.com/en/comps/9/2018-2019/defense/2018-2019-Premier-League-Stats"
"Fernando Llorente","Tottenham",2019,"es ESP","FW",33,1985,7.7,4,2,3,0,1,2,3,66.7,1,7,2,5,1,5,10,0,"Matches","https://fbref.com/en/comps/9/2018-2019/defense/2018-2019-Premier-League-Stats"
"Hugo Lloris","Tottenham",2019,"fr FRA","GK",31,1986,33,1,0,1,0,0,0,2,0,2,0,0,0,0,1,13,5,"Matches","https://fbref.com/en/comps/9/2018-2019/defense/2018-2019-Premier-League-Stats"
"Jürgen Locadia","Brighton",2019,"nl NED","FW,MF",24,1993,13.7,15,10,5,8,2,3,7,42.9,4,8,0,8,9,24,13,0,"Matches","https://fbref.com/en/comps/9/2018-2019/defense/2018-2019-Premier-League-Stats"
"Ruben Loftus-Cheek","Chelsea",2019,"eng ENG","MF,FW",22,1996,11.1,18,12,7,7,4,3,12,25,9,10,4,6,11,29,5,0,"Matches","https://fbref.com/en/comps/9/2018-2019/defense/2018-2019-Premier-League-Stats"
"Kevin Long","Burnley",2019,"ie IRL","DF",27,1990,5.7,18,10,13,5,0,7,17,41.2,10,7,5,2,7,25,35,1,"Matches","https://fbref.com/en/comps/9/2018-2019/defense/2018-2019-Premier-League-Stats"
"Shane Long","Southampton",2019,"ie IRL","FW,MF",31,1987,14.1,15,8,4,5,6,3,16,18.8,13,10,1,9,7,22,18,0,"Matches","https://fbref.com/en/comps/9/2018-2019/defense/2018-2019-Premier-League-Stats"
"Sean Longstaff","Newcastle Utd",2019,"eng ENG","MF",20,1997,7.6,17,13,6,11,0,9,24,37.5,15,19,4,15,10,27,7,0,"Matches","https://fbref.com/en/comps/9/2018-2019/defense/2018-2019-Premier-League-Stats"
"Ademola Lookman","Everton",2019,"ng NGA","FW,MF",20,1997,6.9,15,7,7,5,3,4,6,66.7,2,10,0,10,7,22,2,0,"Matches","https://fbref.com/en/comps/9/2018-2019/defense/2018-2019-Premier-League-Stats"
"Jonas Lössl","Huddersfield",2019,"dk DEN","GK",29,1989,30.9,0,0,0,0,0,0,1,0,1,1,0,1,2,2,12,2,"Matches","https://fbref.com/en/comps/9/2018-2019/defense/2018-2019-Premier-League-Stats"
"Dejan Lovren","Liverpool",2019,"hr CRO","DF",29,1989,11,15,9,10,5,0,7,15,46.7,8,11,7,4,11,26,51,2,"Matches","https://fbref.com/en/comps/9/2018-2019/defense/2018-2019-Premier-League-Stats"
"Chris Löwe","Huddersfield",2019,"de GER","DF,MF",29,1989,22.9,34,18,17,15,2,12,33,36.4,21,21,3,18,23,57,56,0,"Matches","https://fbref.com/en/comps/9/2018-2019/defense/2018-2019-Premier-League-Stats"
"Matthew Lowton","Burnley",2019,"eng ENG","DF",29,1989,19.4,56,35,21,31,4,32,60,53.3,28,29,7,22,30,86,80,1,"Matches","https://fbref.com/en/comps/9/2018-2019/defense/2018-2019-Premier-League-Stats"
"David Luiz","Chelsea",2019,"br BRA","DF",31,1987,36,41,31,27,13,1,21,28,75,7,33,18,15,35,76,149,1,"Matches","https://fbref.com/en/comps/9/2018-2019/defense/2018-2019-Premier-League-Stats"
"Romelu Lukaku","Manchester Utd",2019,"be BEL","FW",25,1993,23.7,8,4,0,6,2,2,10,20,8,12,1,11,2,10,19,0,"Matches","https://fbref.com/en/comps/9/2018-2019/defense/2018-2019-Premier-League-Stats"
"James Maddison","Leicester City",2019,"eng ENG","MF,FW",21,1996,31.5,48,32,20,25,3,14,58,24.1,44,20,4,16,12,60,10,1,"Matches","https://fbref.com/en/comps/9/2018-2019/defense/2018-2019-Premier-League-Stats"
"Gary Madine","Cardiff City",2019,"eng ENG","FW,MF",27,1990,0.4,1,1,0,1,0,0,0,NA,0,0,0,0,0,1,0,0,"Matches","https://fbref.com/en/comps/9/2018-2019/defense/2018-2019-Premier-League-Stats"
"Harry Maguire","Leicester City",2019,"eng ENG","DF",25,1993,28.8,31,17,21,9,1,11,17,64.7,6,32,18,14,36,67,155,4,"Matches","https://fbref.com/en/comps/9/2018-2019/defense/2018-2019-Premier-League-Stats"
"Riyad Mahrez","Manchester City",2019,"dz ALG","FW,MF",27,1991,14.9,14,7,3,7,4,6,18,33.3,12,18,1,17,9,23,3,1,"Matches","https://fbref.com/en/comps/9/2018-2019/defense/2018-2019-Premier-League-Stats"
"Ainsley Maitland-Niles","Arsenal",2019,"eng ENG","DF",20,1997,11,33,22,19,12,2,14,28,50,14,22,4,18,19,52,15,2,"Matches","https://fbref.com/en/comps/9/2018-2019/defense/2018-2019-Premier-League-Stats"
"Sadio Mané","Liverpool",2019,"sn SEN","FW",26,1992,34.2,35,29,12,17,6,14,43,32.6,29,28,4,24,15,50,10,1,"Matches","https://fbref.com/en/comps/9/2018-2019/defense/2018-2019-Premier-League-Stats"
"Javier Manquillo","Newcastle Utd",2019,"es ESP","DF",24,1994,12.2,27,19,14,11,2,9,14,64.3,5,9,1,8,17,44,58,0,"Matches","https://fbref.com/en/comps/9/2018-2019/defense/2018-2019-Premier-League-Stats"
"Solly March","Brighton",2019,"eng ENG","FW,MF",24,1994,27.4,56,24,27,16,13,19,45,42.2,26,34,4,30,27,83,44,0,"Matches","https://fbref.com/en/comps/9/2018-2019/defense/2018-2019-Premier-League-Stats"
"Adrian Mariappa","Watford",2019,"jm JAM","DF",31,1986,21.4,35,22,29,6,0,16,32,50,16,23,15,8,26,61,120,2,"Matches","https://fbref.com/en/comps/9/2018-2019/defense/2018-2019-Premier-League-Stats"
"Lazar Markovic","Fulham",2019,"rs SRB","MF",24,1994,0.5,0,0,0,0,0,0,0,NA,0,0,0,0,0,0,2,0,"Matches","https://fbref.com/en/comps/9/2018-2019/defense/2018-2019-Premier-League-Stats"
"Anthony Martial","Manchester Utd",2019,"fr FRA","FW",22,1995,18,9,7,2,5,2,1,11,9.1,10,12,0,12,3,12,8,0,"Matches","https://fbref.com/en/comps/9/2018-2019/defense/2018-2019-Premier-League-Stats"
"Adam Masina","Watford",2019,"ma MAR","DF",24,1994,11.2,30,17,16,13,1,13,25,52,12,19,4,15,17,47,40,0,"Matches","https://fbref.com/en/comps/9/2018-2019/defense/2018-2019-Premier-League-Stats"
"Arthur Masuaku","West Ham",2019,"cd COD","DF",24,1993,19.5,57,25,38,13,6,31,56,55.4,25,27,6,21,36,93,72,0,"Matches","https://fbref.com/en/comps/9/2018-2019/defense/2018-2019-Premier-League-Stats"
"Juan Mata","Manchester Utd",2019,"es ESP","FW,MF",30,1988,14.3,9,4,7,1,1,6,21,28.6,15,8,1,7,6,15,6,0,"Matches","https://fbref.com/en/comps/9/2018-2019/defense/2018-2019-Premier-League-Stats"
"Nemanja Matic","Manchester Utd",2019,"rs SRB","MF",29,1988,27.1,50,30,27,19,4,30,59,50.8,29,39,18,21,31,81,53,4,"Matches","https://fbref.com/en/comps/9/2018-2019/defense/2018-2019-Premier-League-Stats"
"Joël Matip","Liverpool",2019,"cm CMR","DF",26,1991,17.1,39,26,23,12,4,13,24,54.2,11,12,7,5,32,71,78,0,"Matches","https://fbref.com/en/comps/9/2018-2019/defense/2018-2019-Premier-League-Stats"
"Konstantinos Mavropanos","Arsenal",2019,"gr GRE","DF",20,1997,1.6,1,0,0,1,0,1,1,100,0,1,1,0,7,8,5,0,"Matches","https://fbref.com/en/comps/9/2018-2019/defense/2018-2019-Premier-League-Stats"
"Alfie Mawson","Fulham",2019,"eng ENG","DF",24,1994,12.6,11,7,7,4,0,6,10,60,4,20,17,3,19,30,64,1,"Matches","https://fbref.com/en/comps/9/2018-2019/defense/2018-2019-Premier-League-Stats"
"Isaac Mbenza","Huddersfield",2019,"be BEL","FW,MF",22,1996,11,10,9,5,5,0,2,4,50,2,4,0,4,5,15,4,0,"Matches","https://fbref.com/en/comps/9/2018-2019/defense/2018-2019-Premier-League-Stats"
"James McArthur","Crystal Palace",2019,"sct SCO","MF",30,1987,34,84,51,38,32,14,30,78,38.5,48,64,22,42,39,123,55,0,"Matches","https://fbref.com/en/comps/9/2018-2019/defense/2018-2019-Premier-League-Stats"
"Alex McCarthy","Southampton",2019,"eng ENG","GK",28,1989,25,0,0,0,0,0,0,0,NA,0,0,0,0,0,0,6,2,"Matches","https://fbref.com/en/comps/9/2018-2019/defense/2018-2019-Premier-League-Stats"
"James McCarthy","Everton",2019,"ie IRL","MF",27,1990,0.2,2,1,1,1,0,0,0,NA,0,0,0,0,1,3,0,0,"Matches","https://fbref.com/en/comps/9/2018-2019/defense/2018-2019-Premier-League-Stats"
"Kevin McDonald","Fulham",2019,"sct SCO","MF",29,1988,9.3,15,11,6,8,1,5,13,38.5,8,8,2,6,9,24,22,0,"Matches","https://fbref.com/en/comps/9/2018-2019/defense/2018-2019-Premier-League-Stats"
"Dwight McNeil","Burnley",2019,"eng ENG","MF",18,1999,17.7,36,22,16,17,3,13,44,29.5,31,30,3,27,13,49,35,0,"Matches","https://fbref.com/en/comps/9/2018-2019/defense/2018-2019-Premier-League-Stats"
"Scott McTominay","Manchester Utd",2019,"sct SCO","MF,DF",21,1996,9.6,10,9,3,6,1,4,10,40,6,9,4,5,15,25,16,0,"Matches","https://fbref.com/en/comps/9/2018-2019/defense/2018-2019-Premier-League-Stats"
"Ben Mee","Burnley",2019,"eng ENG","DF",28,1989,38,55,24,38,17,0,35,44,79.5,9,59,50,9,48,103,235,4,"Matches","https://fbref.com/en/comps/9/2018-2019/defense/2018-2019-Premier-League-Stats"
"Nathaniel Mendez-Laing","Cardiff City",2019,"eng ENG","MF,FW",26,1992,10.9,34,25,18,12,4,12,26,46.2,14,17,1,16,13,47,20,0,"Matches","https://fbref.com/en/comps/9/2018-2019/defense/2018-2019-Premier-League-Stats"
"Benjamin Mendy","Manchester City",2019,"fr FRA","DF",24,1994,10,16,10,10,5,1,9,17,52.9,8,13,4,9,10,26,18,0,"Matches","https://fbref.com/en/comps/9/2018-2019/defense/2018-2019-Premier-League-Stats"
"Nampalys Mendy","Leicester City",2019,"sn SEN","MF",26,1992,23.2,33,18,16,16,1,6,22,27.3,16,24,8,16,26,59,26,2,"Matches","https://fbref.com/en/comps/9/2018-2019/defense/2018-2019-Premier-League-Stats"
"Chris Mepham","Bournemouth",2019,"wls WAL","DF",20,1997,9.4,9,3,9,0,0,7,11,63.6,4,12,5,7,14,23,57,2,"Matches","https://fbref.com/en/comps/9/2018-2019/defense/2018-2019-Premier-League-Stats"
"Max Meyer","Crystal Palace",2019,"de GER","MF",22,1995,15.7,33,18,14,18,1,11,20,55,9,6,0,6,15,48,19,0,"Matches","https://fbref.com/en/comps/9/2018-2019/defense/2018-2019-Premier-League-Stats"
"Luka Milivojevic","Crystal Palace",2019,"rs SRB","MF",27,1991,38,90,69,36,47,7,39,91,42.9,52,47,15,32,72,162,68,3,"Matches","https://fbref.com/en/comps/9/2018-2019/defense/2018-2019-Premier-League-Stats"
"James Milner","Liverpool",2019,"eng ENG","MF,DF",32,1986,19.9,43,23,14,24,5,15,41,36.6,26,40,5,35,18,61,30,0,"Matches","https://fbref.com/en/comps/9/2018-2019/defense/2018-2019-Premier-League-Stats"
"Yerry Mina","Everton",2019,"co COL","DF",23,1994,9.9,14,7,8,6,0,6,9,66.7,3,11,5,6,8,22,54,3,"Matches","https://fbref.com/en/comps/9/2018-2019/defense/2018-2019-Premier-League-Stats"
"Tyrone Mings","Bournemouth",2019,"eng ENG","DF",25,1993,1.6,4,3,3,1,0,2,3,66.7,1,5,2,3,6,10,8,0,"Matches","https://fbref.com/en/comps/9/2018-2019/defense/2018-2019-Premier-League-Stats"
"Aleksandar Mitrovic","Fulham",2019,"rs SRB","FW",23,1994,36.4,19,9,3,13,3,5,15,33.3,10,22,8,14,6,25,53,0,"Matches","https://fbref.com/en/comps/9/2018-2019/defense/2018-2019-Premier-League-Stats"
"Henrikh Mkhitaryan","Arsenal",2019,"am ARM","FW,MF",29,1989,18.2,28,22,8,17,3,6,22,27.3,16,34,2,32,16,44,13,0,"Matches","https://fbref.com/en/comps/9/2018-2019/defense/2018-2019-Premier-League-Stats"
"Nacho Monreal","Arsenal",2019,"es ESP","DF",32,1986,20.7,35,17,21,9,5,15,25,60,10,28,10,18,31,66,62,0,"Matches","https://fbref.com/en/comps/9/2018-2019/defense/2018-2019-Premier-League-Stats"
"Martín Montoya","Brighton",2019,"es ESP","DF",27,1991,24.1,58,35,29,21,8,32,55,58.2,23,30,10,20,48,106,76,1,"Matches","https://fbref.com/en/comps/9/2018-2019/defense/2018-2019-Premier-League-Stats"
"Aaron Mooy","Huddersfield",2019,"au AUS","MF,FW",27,1990,25.9,62,42,19,27,16,21,52,40.4,31,43,7,36,14,76,22,0,"Matches","https://fbref.com/en/comps/9/2018-2019/defense/2018-2019-Premier-League-Stats"
"Álvaro Morata","Chelsea",2019,"es ESP","FW",25,1992,10.5,8,5,0,5,3,1,7,14.3,6,6,1,5,0,8,6,0,"Matches","https://fbref.com/en/comps/9/2018-2019/defense/2018-2019-Premier-League-Stats"
"Alberto Moreno","Liverpool",2019,"es ESP","DF",26,1992,1.7,3,2,1,2,0,1,3,33.3,2,1,0,1,2,5,0,0,"Matches","https://fbref.com/en/comps/9/2018-2019/defense/2018-2019-Premier-League-Stats"
"Wes Morgan","Leicester City",2019,"jm JAM","DF",34,1984,21.4,27,15,14,12,1,6,7,85.7,1,24,10,14,32,59,109,1,"Matches","https://fbref.com/en/comps/9/2018-2019/defense/2018-2019-Premier-League-Stats"
"Sean Morrison","Cardiff City",2019,"eng ENG","DF",27,1991,33.8,35,17,29,4,2,15,28,53.6,13,47,30,17,52,87,204,5,"Matches","https://fbref.com/en/comps/9/2018-2019/defense/2018-2019-Premier-League-Stats"
"Victor Moses","Chelsea",2019,"ng NGA","FW",27,1990,0.3,0,0,0,0,0,0,0,NA,0,1,0,1,0,0,0,0,"Matches","https://fbref.com/en/comps/9/2018-2019/defense/2018-2019-Premier-League-Stats"
"Steve Mounié","Huddersfield",2019,"bj BEN","FW",23,1994,19.8,9,6,3,4,2,2,12,16.7,10,10,1,9,5,14,15,0,"Matches","https://fbref.com/en/comps/9/2018-2019/defense/2018-2019-Premier-League-Stats"
"Lucas Moura","Tottenham",2019,"br BRA","FW,MF",25,1992,23.6,35,18,8,20,7,9,27,33.3,18,15,1,14,24,59,24,0,"Matches","https://fbref.com/en/comps/9/2018-2019/defense/2018-2019-Premier-League-Stats"
"Lys Mousset","Bournemouth",2019,"fr FRA","FW",22,1996,4.1,3,1,1,1,1,1,4,25,3,3,0,3,1,4,3,0,"Matches","https://fbref.com/en/comps/9/2018-2019/defense/2018-2019-Premier-League-Stats"
"João Moutinho","Wolves",2019,"pt POR","MF",31,1986,33.7,113,58,50,56,7,44,126,34.9,82,56,11,45,40,153,50,0,"Matches","https://fbref.com/en/comps/9/2018-2019/defense/2018-2019-Premier-League-Stats"
"Jacob Murphy","Newcastle Utd",2019,"eng ENG","MF,DF",23,1995,3.4,6,2,4,2,0,2,4,50,2,5,2,3,1,7,7,0,"Matches","https://fbref.com/en/comps/9/2018-2019/defense/2018-2019-Premier-League-Stats"
"Josh Murphy","Cardiff City",2019,"eng ENG","MF,FW",23,1995,20.2,26,17,15,7,4,9,29,31,20,30,0,30,11,37,17,0,"Matches","https://fbref.com/en/comps/9/2018-2019/defense/2018-2019-Premier-League-Stats"
"Glenn Murray","Brighton",2019,"eng ENG","FW",34,1983,27.9,17,7,4,7,6,4,20,20,16,20,3,17,2,19,17,1,"Matches","https://fbref.com/en/comps/9/2018-2019/defense/2018-2019-Premier-League-Stats"
"Shkodran Mustafi","Arsenal",2019,"de GER","DF",26,1992,29,62,45,42,17,3,31,40,77.5,9,34,17,17,58,120,168,1,"Matches","https://fbref.com/en/comps/9/2018-2019/defense/2018-2019-Premier-League-Stats"
"Yoshinori Muto","Newcastle Utd",2019,"jp JPN","FW,MF",26,1992,5.8,8,4,3,5,0,2,7,28.6,5,9,0,9,5,13,3,1,"Matches","https://fbref.com/en/comps/9/2018-2019/defense/2018-2019-Premier-League-Stats"
"Georges-Kévin N'Koudou","Tottenham",2019,"cm CMR","FW",23,1995,0.1,0,0,0,0,0,0,0,NA,0,0,0,0,0,0,0,0,"Matches","https://fbref.com/en/comps/9/2018-2019/defense/2018-2019-Premier-League-Stats"
"Samir Nasri","West Ham",2019,"fr FRA","MF",31,1987,2.7,0,0,0,0,0,0,0,NA,0,1,0,1,1,1,1,0,"Matches","https://fbref.com/en/comps/9/2018-2019/defense/2018-2019-Premier-League-Stats"
"Marc Navarro","Watford",2019,"es ESP","DF",23,1995,0.9,4,2,3,1,0,3,4,75,1,0,0,0,0,4,4,0,"Matches","https://fbref.com/en/comps/9/2018-2019/defense/2018-2019-Premier-League-Stats"
"Wilfred Ndidi","Leicester City",2019,"ng NGA","MF",21,1996,36.6,142,98,66,67,9,46,95,48.4,49,64,9,55,83,225,85,2,"Matches","https://fbref.com/en/comps/9/2018-2019/defense/2018-2019-Premier-League-Stats"
"Rúben Neves","Wolves",2019,"pt POR","MF",21,1997,33.4,75,32,33,36,6,27,83,32.5,56,57,18,39,73,148,46,3,"Matches","https://fbref.com/en/comps/9/2018-2019/defense/2018-2019-Premier-League-Stats"
"Oumar Niasse","Cardiff City",2019,"sn SEN","FW",28,1990,10.3,12,3,1,5,6,4,8,50,4,7,0,7,2,14,7,0,"Matches","https://fbref.com/en/comps/9/2018-2019/defense/2018-2019-Premier-League-Stats"
"Oumar Niasse","Everton",2019,"sn SEN","FW",28,1990,0.7,0,0,0,0,0,0,1,0,1,0,0,0,0,0,0,0,"Matches","https://fbref.com/en/comps/9/2018-2019/defense/2018-2019-Premier-League-Stats"
"Eddie Nketiah","Arsenal",2019,"eng ENG","MF,FW",19,1999,0.7,1,1,0,1,0,0,0,NA,0,0,0,0,0,1,1,0,"Matches","https://fbref.com/en/comps/9/2018-2019/defense/2018-2019-Premier-League-Stats"
"Mark Noble","West Ham",2019,"eng ENG","MF",31,1987,25.5,47,26,19,24,4,17,52,32.7,35,17,2,15,21,68,13,0,"Matches","https://fbref.com/en/comps/9/2018-2019/defense/2018-2019-Premier-League-Stats"
"Håvard Nordtveit","Fulham",2019,"no NOR","DF",28,1990,4,9,4,8,1,0,4,5,80,1,3,3,0,8,17,15,1,"Matches","https://fbref.com/en/comps/9/2018-2019/defense/2018-2019-Premier-League-Stats"
"Will Norris","Wolves",2019,"eng ENG","GK",24,1993,0,0,0,0,0,0,0,0,NA,0,0,0,0,0,0,0,0,"Matches","https://fbref.com/en/comps/9/2018-2019/defense/2018-2019-Premier-League-Stats"
"Michael Obafemi","Southampton",2019,"ie IRL","FW",18,2000,1.5,1,1,0,0,1,0,0,NA,0,1,1,0,1,2,0,0,"Matches","https://fbref.com/en/comps/9/2018-2019/defense/2018-2019-Premier-League-Stats"
"Pedro Obiang","West Ham",2019,"gq EQG","MF",26,1992,12.5,41,23,23,16,2,18,43,41.9,25,27,9,18,12,53,18,0,"Matches","https://fbref.com/en/comps/9/2018-2019/defense/2018-2019-Premier-League-Stats"
"Denis Odoi","Fulham",2019,"gh GHA","DF",30,1988,28.8,48,34,29,16,3,21,33,63.6,12,45,24,21,42,90,153,0,"Matches","https://fbref.com/en/comps/9/2018-2019/defense/2018-2019-Premier-League-Stats"
"Angelo Ogbonna","West Ham",2019,"it ITA","DF",30,1988,20.8,31,13,23,6,2,14,23,60.9,9,29,19,10,35,66,101,0,"Matches","https://fbref.com/en/comps/9/2018-2019/defense/2018-2019-Premier-League-Stats"
"Stefano Okaka","Watford",2019,"it ITA","FW,MF",28,1989,0.3,0,0,0,0,0,0,0,NA,0,1,0,1,0,0,0,0,"Matches","https://fbref.com/en/comps/9/2018-2019/defense/2018-2019-Premier-League-Stats"
"Shinji Okazaki","Leicester City",2019,"jp JPN","MF,FW",32,1986,3.2,5,5,2,3,0,0,1,0,1,7,1,6,2,7,1,0,"Matches","https://fbref.com/en/comps/9/2018-2019/defense/2018-2019-Premier-League-Stats"
"Divock Origi","Liverpool",2019,"be BEL","FW",23,1995,4.1,6,1,2,3,1,1,4,25,3,2,0,2,0,6,2,0,"Matches","https://fbref.com/en/comps/9/2018-2019/defense/2018-2019-Premier-League-Stats"
"Nicolás Otamendi","Manchester City",2019,"ar ARG","DF",30,1988,13.7,24,14,17,6,1,5,9,55.6,4,6,4,2,29,53,56,1,"Matches","https://fbref.com/en/comps/9/2018-2019/defense/2018-2019-Premier-League-Stats"
"Alex Oxlade-Chamberlain","Liverpool",2019,"eng ENG","MF",24,1993,0.2,1,1,0,1,0,1,1,100,0,0,0,0,1,2,0,0,"Matches","https://fbref.com/en/comps/9/2018-2019/defense/2018-2019-Premier-League-Stats"
"Mesut Özil","Arsenal",2019,"de GER","MF,FW",29,1988,19.3,12,5,6,3,3,3,21,14.3,18,10,2,8,4,16,5,0,"Matches","https://fbref.com/en/comps/9/2018-2019/defense/2018-2019-Premier-League-Stats"
"Emerson Palmieri","Chelsea",2019,"it ITA","DF",23,1994,7.4,14,9,6,5,3,6,10,60,4,11,1,10,8,22,14,0,"Matches","https://fbref.com/en/comps/9/2018-2019/defense/2018-2019-Premier-League-Stats"
"Sokratis Papastathopoulos","Arsenal",2019,"gr GRE","DF",30,1988,24.4,42,25,30,11,1,15,28,53.6,13,34,17,17,26,68,112,1,"Matches","https://fbref.com/en/comps/9/2018-2019/defense/2018-2019-Premier-League-Stats"
"Callum Paterson","Cardiff City",2019,"sct SCO","FW,MF",23,1994,22.2,21,14,7,7,7,5,26,19.2,21,23,2,21,8,29,29,0,"Matches","https://fbref.com/en/comps/9/2018-2019/defense/2018-2019-Premier-League-Stats"
"Rui Patrício","Wolves",2019,"pt POR","GK",30,1988,37,2,0,2,0,0,2,3,66.7,1,0,0,0,1,3,7,4,"Matches","https://fbref.com/en/comps/9/2018-2019/defense/2018-2019-Premier-League-Stats"
"Pedro","Chelsea",2019,"es ESP","FW",31,1987,19.8,27,14,11,10,6,9,35,25.7,26,13,2,11,18,45,8,1,"Matches","https://fbref.com/en/comps/9/2018-2019/defense/2018-2019-Premier-League-Stats"
"Lee Peltier","Cardiff City",2019,"eng ENG","DF",31,1986,17.2,39,25,27,11,1,15,27,55.6,12,18,12,6,18,57,60,0,"Matches","https://fbref.com/en/comps/9/2018-2019/defense/2018-2019-Premier-League-Stats"
"Andreas Pereira","Manchester Utd",2019,"br BRA","MF",22,1996,6.7,8,6,5,2,1,4,15,26.7,11,9,2,7,11,19,8,1,"Matches","https://fbref.com/en/comps/9/2018-2019/defense/2018-2019-Premier-League-Stats"
"Ricardo Pereira","Leicester City",2019,"pt POR","DF,FW",24,1993,34.7,118,66,66,40,12,54,112,48.2,58,60,6,54,60,178,130,1,"Matches","https://fbref.com/en/comps/9/2018-2019/defense/2018-2019-Premier-League-Stats"
"Roberto Pereyra","Watford",2019,"ar ARG","MF",27,1991,31.3,21,12,10,10,1,7,24,29.2,17,26,0,26,24,45,27,2,"Matches","https://fbref.com/en/comps/9/2018-2019/defense/2018-2019-Premier-League-Stats"
"Ayoze Pérez","Newcastle Utd",2019,"es ESP","MF,FW",25,1993,32.4,59,22,24,28,7,17,63,27,46,55,4,51,42,101,33,1,"Matches","https://fbref.com/en/comps/9/2018-2019/defense/2018-2019-Premier-League-Stats"
"Lucas Pérez","West Ham",2019,"es ESP","FW,MF",29,1988,5.3,6,4,3,2,1,1,3,33.3,2,2,1,1,2,8,2,0,"Matches","https://fbref.com/en/comps/9/2018-2019/defense/2018-2019-Premier-League-Stats"
"Jordan Pickford","Everton",2019,"eng ENG","GK",24,1994,38,0,0,0,0,0,0,0,NA,0,0,0,0,0,0,20,8,"Matches","https://fbref.com/en/comps/9/2018-2019/defense/2018-2019-Premier-League-Stats"
"Paul Pogba","Manchester Utd",2019,"fr FRA","MF",25,1993,33.4,47,30,21,21,5,17,43,39.5,26,30,9,21,18,65,39,0,"Matches","https://fbref.com/en/comps/9/2018-2019/defense/2018-2019-Premier-League-Stats"
"Alex Pritchard","Huddersfield",2019,"eng ENG","MF,FW",25,1993,23.1,36,24,10,18,8,10,35,28.6,25,26,2,24,17,53,9,0,"Matches","https://fbref.com/en/comps/9/2018-2019/defense/2018-2019-Premier-League-Stats"
"Sebastian Prödl","Watford",2019,"at AUT","DF",31,1987,0.1,0,0,0,0,0,0,0,NA,0,0,0,0,0,0,0,0,"Matches","https://fbref.com/en/comps/9/2018-2019/defense/2018-2019-Premier-League-Stats"
"Davy Pröpper","Brighton",2019,"nl NED","MF",26,1991,28.3,50,28,23,21,6,16,52,30.8,36,21,6,15,53,103,37,0,"Matches","https://fbref.com/en/comps/9/2018-2019/defense/2018-2019-Premier-League-Stats"
"Jason Puncheon","Crystal Palace",2019,"eng ENG","MF",32,1986,0.1,1,1,1,0,0,0,0,NA,0,0,0,0,0,1,0,0,"Matches","https://fbref.com/en/comps/9/2018-2019/defense/2018-2019-Premier-League-Stats"
"Jason Puncheon","Huddersfield",2019,"eng ENG","MF",32,1986,4.2,7,4,1,5,1,1,7,14.3,6,3,1,2,3,10,8,0,"Matches","https://fbref.com/en/comps/9/2018-2019/defense/2018-2019-Premier-League-Stats"
"Collin Quaner","Huddersfield",2019,"de GER","FW",27,1991,0.4,0,0,0,0,0,0,1,0,1,0,0,0,0,0,0,0,"Matches","https://fbref.com/en/comps/9/2018-2019/defense/2018-2019-Premier-League-Stats"
"Domingos Quina","Watford",2019,"pt POR","MF",18,1999,3.8,9,7,3,5,1,3,11,27.3,8,6,0,6,3,12,1,0,"Matches","https://fbref.com/en/comps/9/2018-2019/defense/2018-2019-Premier-League-Stats"
"Joe Ralls","Cardiff City",2019,"eng ENG","MF",24,1993,21.8,45,23,21,21,3,10,33,30.3,23,21,6,15,29,74,30,0,"Matches","https://fbref.com/en/comps/9/2018-2019/defense/2018-2019-Premier-League-Stats"
"Aaron Ramsey","Arsenal",2019,"wls WAL","MF",27,1990,14.8,34,18,11,15,8,7,25,28,18,7,1,6,9,43,3,0,"Matches","https://fbref.com/en/comps/9/2018-2019/defense/2018-2019-Premier-League-Stats"
"Kayne Ramsey","Southampton",2019,"eng ENG","DF",17,2000,1,0,0,0,0,0,0,0,NA,0,0,0,0,0,0,7,0,"Matches","https://fbref.com/en/comps/9/2018-2019/defense/2018-2019-Premier-League-Stats"
"Marcus Rashford","Manchester Utd",2019,"eng ENG","FW",20,1997,25.9,24,12,4,12,8,7,29,24.1,22,27,0,27,3,27,24,0,"Matches","https://fbref.com/en/comps/9/2018-2019/defense/2018-2019-Premier-League-Stats"
"Tim Ream","Fulham",2019,"us USA","DF",30,1987,22.7,23,14,16,7,0,14,28,50,14,19,10,9,25,48,80,2,"Matches","https://fbref.com/en/comps/9/2018-2019/defense/2018-2019-Premier-League-Stats"
"Nathan Redmond","Southampton",2019,"eng ENG","MF,FW",24,1994,36.3,45,22,14,19,12,14,41,34.1,27,54,2,52,20,65,23,1,"Matches","https://fbref.com/en/comps/9/2018-2019/defense/2018-2019-Premier-League-Stats"
"Bobby Reid","Cardiff City",2019,"jm JAM","FW,MF",25,1993,15.8,16,9,6,7,3,3,8,37.5,5,13,0,13,3,19,12,0,"Matches","https://fbref.com/en/comps/9/2018-2019/defense/2018-2019-Premier-League-Stats"
"Declan Rice","West Ham",2019,"eng ENG","MF",19,1999,33.4,98,60,35,58,5,38,88,43.2,50,51,12,39,52,150,56,0,"Matches","https://fbref.com/en/comps/9/2018-2019/defense/2018-2019-Premier-League-Stats"
"Jazz Richards","Cardiff City",2019,"wls WAL","DF,MF",27,1991,1.5,0,0,0,0,0,0,1,0,1,2,1,1,2,2,5,0,"Matches","https://fbref.com/en/comps/9/2018-2019/defense/2018-2019-Premier-League-Stats"
"Richarlison","Everton",2019,"br BRA","FW,MF",21,1997,29.6,49,34,19,20,10,8,24,33.3,16,30,2,28,16,65,39,0,"Matches","https://fbref.com/en/comps/9/2018-2019/defense/2018-2019-Premier-League-Stats"
"Diego Rico","Bournemouth",2019,"es ESP","DF,MF",25,1993,6.8,14,9,8,2,4,4,12,33.3,8,13,2,11,14,28,20,0,"Matches","https://fbref.com/en/comps/9/2018-2019/defense/2018-2019-Premier-League-Stats"
"Sergio Rico","Fulham",2019,"es ESP","GK",24,1993,29,1,1,1,0,0,1,1,100,0,0,0,0,1,2,13,5,"Matches","https://fbref.com/en/comps/9/2018-2019/defense/2018-2019-Premier-League-Stats"
"Matt Ritchie","Newcastle Utd",2019,"sct SCO","DF,MF",28,1989,32.5,70,44,35,27,8,19,47,40.4,28,34,11,23,51,121,76,1,"Matches","https://fbref.com/en/comps/9/2018-2019/defense/2018-2019-Premier-League-Stats"
"Andrew Robertson","Liverpool",2019,"sct SCO","DF",24,1994,35.7,80,49,41,31,8,39,70,55.7,31,33,6,27,29,109,57,3,"Matches","https://fbref.com/en/comps/9/2018-2019/defense/2018-2019-Premier-League-Stats"
"Marcos Rojo","Manchester Utd",2019,"ar ARG","DF",28,1990,2.4,5,3,3,2,0,1,6,16.7,5,3,2,1,6,11,9,1,"Matches","https://fbref.com/en/comps/9/2018-2019/defense/2018-2019-Premier-League-Stats"
"Oriol Romeu","Southampton",2019,"es ESP","MF",26,1991,23.7,81,46,39,38,4,32,77,41.6,45,43,17,26,52,133,44,1,"Matches","https://fbref.com/en/comps/9/2018-2019/defense/2018-2019-Premier-League-Stats"
"Salomón Rondón","Newcastle Utd",2019,"ve VEN","FW",28,1989,28.9,8,3,2,4,2,4,24,16.7,20,14,3,11,5,13,39,0,"Matches","https://fbref.com/en/comps/9/2018-2019/defense/2018-2019-Premier-League-Stats"
"Danny Rose","Tottenham",2019,"eng ENG","DF",28,1990,20,49,31,26,16,7,20,32,62.5,12,24,4,20,24,73,28,3,"Matches","https://fbref.com/en/comps/9/2018-2019/defense/2018-2019-Premier-League-Stats"
"Aaron Rowe","Huddersfield",2019,"eng ENG","FW",17,2000,0.8,1,0,1,0,0,0,0,NA,0,0,0,0,1,2,1,0,"Matches","https://fbref.com/en/comps/9/2018-2019/defense/2018-2019-Premier-League-Stats"
"John Ruddy","Wolves",2019,"eng ENG","GK",31,1986,1,0,0,0,0,0,0,0,NA,0,0,0,0,0,0,0,0,"Matches","https://fbref.com/en/comps/9/2018-2019/defense/2018-2019-Premier-League-Stats"
"Antonio Rüdiger","Chelsea",2019,"de GER","DF",25,1993,31.9,34,16,27,6,1,15,27,55.6,12,15,8,7,32,66,96,1,"Matches","https://fbref.com/en/comps/9/2018-2019/defense/2018-2019-Premier-League-Stats"
"Mathew Ryan","Brighton",2019,"au AUS","GK",26,1992,34,1,0,1,0,0,1,2,50,1,0,0,0,0,1,13,1,"Matches","https://fbref.com/en/comps/9/2018-2019/defense/2018-2019-Premier-League-Stats"
"Abdelhamid Sabiri","Huddersfield",2019,"ma MAR","FW",21,1996,0.5,2,1,1,1,0,0,0,NA,0,1,0,1,1,3,0,0,"Matches","https://fbref.com/en/comps/9/2018-2019/defense/2018-2019-Premier-League-Stats"
"Romain Saïss","Wolves",2019,"ma MAR","MF,DF",28,1990,12.8,39,26,23,14,2,20,37,54.1,17,25,12,13,26,65,61,0,"Matches","https://fbref.com/en/comps/9/2018-2019/defense/2018-2019-Premier-League-Stats"
"Bukayo Saka","Arsenal",2019,"eng ENG","FW",16,2001,0.1,0,0,0,0,0,0,0,NA,0,0,0,0,0,0,0,0,"Matches","https://fbref.com/en/comps/9/2018-2019/defense/2018-2019-Premier-League-Stats"
"Mamadou Sakho","Crystal Palace",2019,"fr FRA","DF",28,1990,26.8,25,16,22,3,0,11,18,61.1,7,26,16,10,41,66,136,2,"Matches","https://fbref.com/en/comps/9/2018-2019/defense/2018-2019-Premier-League-Stats"
"Bakary Sako","Crystal Palace",2019,"ml MLI","FW",30,1988,0.3,2,1,2,0,0,1,1,100,0,0,0,0,0,2,0,0,"Matches","https://fbref.com/en/comps/9/2018-2019/defense/2018-2019-Premier-League-Stats"
"Mohamed Salah","Liverpool",2019,"eg EGY","FW",26,1992,36.1,21,9,3,11,7,5,16,31.3,11,9,0,9,5,26,6,0,"Matches","https://fbref.com/en/comps/9/2018-2019/defense/2018-2019-Premier-League-Stats"
"Alexis Sánchez","Manchester Utd",2019,"cl CHI","FW,MF",29,1988,9.8,17,10,5,9,3,5,13,38.5,8,7,0,7,9,26,2,0,"Matches","https://fbref.com/en/comps/9/2018-2019/defense/2018-2019-Premier-League-Stats"
"Carlos Sánchez","West Ham",2019,"co COL","MF",32,1986,2.7,4,3,4,0,0,3,8,37.5,5,1,0,1,1,5,5,2,"Matches","https://fbref.com/en/comps/9/2018-2019/defense/2018-2019-Premier-League-Stats"
"Davinson Sánchez","Tottenham",2019,"co COL","DF",22,1996,21.6,37,20,28,9,0,20,37,54.1,17,17,9,8,30,67,103,2,"Matches","https://fbref.com/en/comps/9/2018-2019/defense/2018-2019-Premier-League-Stats"
"Leroy Sané","Manchester City",2019,"de GER","FW",22,1996,20.7,24,15,8,7,9,2,23,8.7,21,21,2,19,8,32,2,0,"Matches","https://fbref.com/en/comps/9/2018-2019/defense/2018-2019-Premier-League-Stats"
"Fabian Schär","Newcastle Utd",2019,"ch SUI","DF",26,1991,22.2,60,39,37,19,4,24,50,48,26,40,16,24,67,127,145,2,"Matches","https://fbref.com/en/comps/9/2018-2019/defense/2018-2019-Premier-League-Stats"
"Christopher Schindler","Huddersfield",2019,"de GER","DF",28,1990,36.2,61,36,46,14,1,27,47,57.4,20,69,34,35,70,131,138,4,"Matches","https://fbref.com/en/comps/9/2018-2019/defense/2018-2019-Premier-League-Stats"
"Jeffrey Schlupp","Crystal Palace",2019,"gh GHA","MF,FW",25,1992,18.6,41,20,18,18,5,10,27,37,17,30,8,22,19,60,27,1,"Matches","https://fbref.com/en/comps/9/2018-2019/defense/2018-2019-Premier-League-Stats"
"Kasper Schmeichel","Leicester City",2019,"dk DEN","GK",31,1986,38,1,1,1,0,0,1,1,100,0,0,0,0,3,4,14,3,"Matches","https://fbref.com/en/comps/9/2018-2019/defense/2018-2019-Premier-League-Stats"
"Morgan Schneiderlin","Everton",2019,"fr FRA","MF",28,1989,9.3,24,16,11,11,2,6,14,42.9,8,16,3,13,15,39,16,0,"Matches","https://fbref.com/en/comps/9/2018-2019/defense/2018-2019-Premier-League-Stats"
"André Schürrle","Fulham",2019,"de GER","FW,MF",27,1990,18.2,30,19,14,10,6,12,42,28.6,30,16,1,15,8,38,17,1,"Matches","https://fbref.com/en/comps/9/2018-2019/defense/2018-2019-Premier-League-Stats"
"Ken Sema","Watford",2019,"se SWE","MF,FW",24,1993,8.4,15,7,7,5,3,9,21,42.9,12,7,0,7,8,23,5,0,"Matches","https://fbref.com/en/comps/9/2018-2019/defense/2018-2019-Premier-League-Stats"
"Jean Seri","Fulham",2019,"ci CIV","MF",27,1991,24.9,41,28,20,20,1,13,45,28.9,32,40,9,31,32,73,17,4,"Matches","https://fbref.com/en/comps/9/2018-2019/defense/2018-2019-Premier-League-Stats"
"Ryan Sessegnon","Fulham",2019,"eng ENG","FW,DF",18,2000,25.6,22,14,8,8,6,6,22,27.3,16,25,2,23,19,41,49,1,"Matches","https://fbref.com/en/comps/9/2018-2019/defense/2018-2019-Premier-League-Stats"
"Xherdan Shaqiri","Liverpool",2019,"ch SUI","FW,MF",26,1991,11.8,14,4,3,9,2,9,19,47.4,10,6,1,5,6,20,6,0,"Matches","https://fbref.com/en/comps/9/2018-2019/defense/2018-2019-Premier-League-Stats"
"Luke Shaw","Manchester Utd",2019,"eng ENG","DF",23,1995,28.8,55,29,17,31,7,28,47,59.6,19,42,12,30,21,76,93,2,"Matches","https://fbref.com/en/comps/9/2018-2019/defense/2018-2019-Premier-League-Stats"
"Jonjo Shelvey","Newcastle Utd",2019,"eng ENG","MF",26,1992,10.5,22,12,10,9,3,8,17,47.1,9,10,3,7,7,29,15,0,"Matches","https://fbref.com/en/comps/9/2018-2019/defense/2018-2019-Premier-League-Stats"
"Gylfi Sigurðsson","Everton",2019,"is ISL","MF",28,1989,34.6,56,36,20,25,11,16,47,34,31,38,4,34,28,84,24,0,"Matches","https://fbref.com/en/comps/9/2018-2019/defense/2018-2019-Premier-League-Stats"
"Adrien Silva","Leicester City",2019,"pt POR","MF",29,1989,1,2,2,0,1,1,0,2,0,2,1,0,1,1,3,1,0,"Matches","https://fbref.com/en/comps/9/2018-2019/defense/2018-2019-Premier-League-Stats"
"Bernardo Silva","Manchester City",2019,"pt POR","MF,FW",23,1994,31.7,52,39,18,21,13,16,67,23.9,51,47,3,44,25,77,26,1,"Matches","https://fbref.com/en/comps/9/2018-2019/defense/2018-2019-Premier-League-Stats"
"David Silva","Manchester City",2019,"es ESP","MF",32,1986,26.7,30,18,12,11,7,1,20,5,19,18,1,17,22,52,15,0,"Matches","https://fbref.com/en/comps/9/2018-2019/defense/2018-2019-Premier-League-Stats"
"Xande Silva","West Ham",2019,"pt POR","FW",21,1997,0.2,0,0,0,0,0,0,0,NA,0,1,0,1,0,0,0,0,"Matches","https://fbref.com/en/comps/9/2018-2019/defense/2018-2019-Premier-League-Stats"
"Danny Simpson","Leicester City",2019,"eng ENG","DF",31,1987,3.2,11,3,8,3,0,3,5,60,2,7,3,4,6,17,20,0,"Matches","https://fbref.com/en/comps/9/2018-2019/defense/2018-2019-Premier-League-Stats"
"Jack Simpson","Bournemouth",2019,"eng ENG","DF",21,1996,4.5,9,5,8,1,0,6,9,66.7,3,5,4,1,9,18,25,2,"Matches","https://fbref.com/en/comps/9/2018-2019/defense/2018-2019-Premier-League-Stats"
"Josh Sims","Southampton",2019,"eng ENG","MF",21,1997,2.4,1,0,1,0,0,1,3,33.3,2,2,0,2,1,2,1,0,"Matches","https://fbref.com/en/comps/9/2018-2019/defense/2018-2019-Premier-League-Stats"
"Moussa Sissoko","Tottenham",2019,"fr FRA","MF,FW",28,1989,25.9,36,25,18,14,4,15,29,51.7,14,31,4,27,16,52,25,2,"Matches","https://fbref.com/en/comps/9/2018-2019/defense/2018-2019-Premier-League-Stats"
"Oliver Skipp","Tottenham",2019,"eng ENG","MF",17,2000,2.4,7,3,4,3,0,4,6,66.7,2,2,1,1,1,8,7,0,"Matches","https://fbref.com/en/comps/9/2018-2019/defense/2018-2019-Premier-League-Stats"
"Callum Slattery","Southampton",2019,"eng ENG","MF",19,1999,1.2,4,3,0,4,0,3,7,42.9,4,1,1,0,2,6,1,0,"Matches","https://fbref.com/en/comps/9/2018-2019/defense/2018-2019-Premier-League-Stats"
"Chris Smalling","Manchester Utd",2019,"eng ENG","DF",28,1989,23.6,30,17,21,9,0,11,17,64.7,6,37,25,12,26,56,109,1,"Matches","https://fbref.com/en/comps/9/2018-2019/defense/2018-2019-Premier-League-Stats"
"Adam Smith","Bournemouth",2019,"eng ENG","DF,MF",27,1991,23,46,32,26,14,6,19,41,46.3,22,26,7,19,31,77,68,1,"Matches","https://fbref.com/en/comps/9/2018-2019/defense/2018-2019-Premier-League-Stats"
"Tommy Smith","Huddersfield",2019,"eng ENG","DF",26,1992,12.7,26,13,14,11,1,10,25,40,15,12,4,8,18,44,25,0,"Matches","https://fbref.com/en/comps/9/2018-2019/defense/2018-2019-Premier-League-Stats"
"Robert Snodgrass","West Ham",2019,"sct SCO","MF",30,1987,24.7,44,27,18,24,2,13,46,28.3,33,24,4,20,11,55,23,0,"Matches","https://fbref.com/en/comps/9/2018-2019/defense/2018-2019-Premier-League-Stats"
"Cédric Soares","Southampton",2019,"pt POR","DF",26,1991,16.6,22,16,15,6,1,9,15,60,6,21,5,16,22,44,60,2,"Matches","https://fbref.com/en/comps/9/2018-2019/defense/2018-2019-Premier-League-Stats"
"Ramadan Sobhi","Huddersfield",2019,"eg EGY","FW,MF",21,1997,0.9,1,1,0,1,0,0,0,NA,0,2,0,2,1,2,0,0,"Matches","https://fbref.com/en/comps/9/2018-2019/defense/2018-2019-Premier-League-Stats"
"Dominic Solanke","Bournemouth",2019,"eng ENG","FW,MF",20,1997,3.9,8,3,1,4,3,1,8,12.5,7,4,1,3,2,10,9,0,"Matches","https://fbref.com/en/comps/9/2018-2019/defense/2018-2019-Premier-League-Stats"
"Pape Souaré","Crystal Palace",2019,"sn SEN","DF",28,1990,0,0,0,0,0,0,0,0,NA,0,0,0,0,1,1,0,0,"Matches","https://fbref.com/en/comps/9/2018-2019/defense/2018-2019-Premier-League-Stats"
"Çaglar Söyüncü","Leicester City",2019,"tr TUR","DF",22,1996,4.1,5,2,4,1,0,3,6,50,3,8,5,3,7,12,22,3,"Matches","https://fbref.com/en/comps/9/2018-2019/defense/2018-2019-Premier-League-Stats"
"Julián Speroni","Crystal Palace",2019,"ar ARG","GK",39,1979,1,0,0,0,0,0,0,0,NA,0,0,0,0,0,0,1,2,"Matches","https://fbref.com/en/comps/9/2018-2019/defense/2018-2019-Premier-League-Stats"
"Junior Stanislas","Bournemouth",2019,"eng ENG","MF,FW",28,1989,11.5,12,6,5,4,3,3,7,42.9,4,8,1,7,2,14,15,0,"Matches","https://fbref.com/en/comps/9/2018-2019/defense/2018-2019-Premier-League-Stats"
"Dale Stephens","Brighton",2019,"eng ENG","MF",29,1989,27.6,83,57,37,41,5,28,74,37.8,46,33,13,20,46,129,47,0,"Matches","https://fbref.com/en/comps/9/2018-2019/defense/2018-2019-Premier-League-Stats"
"Jack Stephens","Southampton",2019,"eng ENG","DF",24,1994,18.9,25,13,17,7,1,16,28,57.1,12,25,13,12,37,62,96,2,"Matches","https://fbref.com/en/comps/9/2018-2019/defense/2018-2019-Premier-League-Stats"
"Raheem Sterling","Manchester City",2019,"eng ENG","FW",23,1994,30.8,32,16,11,12,9,9,25,36,16,28,3,25,17,49,4,0,"Matches","https://fbref.com/en/comps/9/2018-2019/defense/2018-2019-Premier-League-Stats"
"John Stones","Manchester City",2019,"eng ENG","DF",24,1994,19.6,16,11,9,5,2,4,9,44.4,5,15,9,6,14,30,64,1,"Matches","https://fbref.com/en/comps/9/2018-2019/defense/2018-2019-Premier-League-Stats"
"Daniel Sturridge","Liverpool",2019,"eng ENG","FW,MF",28,1989,5.7,3,3,1,1,1,2,3,66.7,1,4,0,4,1,4,0,0,"Matches","https://fbref.com/en/comps/9/2018-2019/defense/2018-2019-Premier-League-Stats"
"Denis Suárez","Arsenal",2019,"es ESP","MF,FW",24,1994,0.8,1,1,0,1,0,0,5,0,5,0,0,0,1,2,0,0,"Matches","https://fbref.com/en/comps/9/2018-2019/defense/2018-2019-Premier-League-Stats"
"Isaac Success","Watford",2019,"ng NGA","FW,MF",22,1996,11.7,15,12,4,8,3,2,5,40,3,6,0,6,2,17,11,0,"Matches","https://fbref.com/en/comps/9/2018-2019/defense/2018-2019-Premier-League-Stats"
"Ki Sung-yueng","Newcastle Utd",2019,"kr KOR","MF",29,1989,14.5,14,10,5,8,1,3,12,25,9,11,1,10,19,33,20,0,"Matches","https://fbref.com/en/comps/9/2018-2019/defense/2018-2019-Premier-League-Stats"
"Andrew Surman","Bournemouth",2019,"eng ENG","MF",31,1986,16,11,6,6,5,0,3,13,23.1,10,20,7,13,10,21,34,1,"Matches","https://fbref.com/en/comps/9/2018-2019/defense/2018-2019-Premier-League-Stats"
"Sam Surridge","Bournemouth",2019,"eng ENG","MF,FW",20,1998,0.1,1,0,0,0,1,0,0,NA,0,0,0,0,0,1,0,0,"Matches","https://fbref.com/en/comps/9/2018-2019/defense/2018-2019-Premier-League-Stats"
"Alexander Sørloth","Crystal Palace",2019,"no NOR","FW",22,1995,2.1,2,1,0,0,2,1,2,50,1,0,0,0,0,2,3,0,"Matches","https://fbref.com/en/comps/9/2018-2019/defense/2018-2019-Premier-League-Stats"
"Matt Targett","Southampton",2019,"eng ENG","DF",22,1995,13.2,27,19,15,7,5,12,26,46.2,14,19,3,16,27,54,42,0,"Matches","https://fbref.com/en/comps/9/2018-2019/defense/2018-2019-Premier-League-Stats"
"James Tarkowski","Burnley",2019,"eng ENG","DF",25,1992,34.3,71,36,52,18,1,29,50,58,21,72,56,16,42,113,240,2,"Matches","https://fbref.com/en/comps/9/2018-2019/defense/2018-2019-Premier-League-Stats"
"Charlie Taylor","Burnley",2019,"eng ENG","DF",24,1993,36,55,26,37,15,3,24,50,48,26,74,35,39,40,95,120,0,"Matches","https://fbref.com/en/comps/9/2018-2019/defense/2018-2019-Premier-League-Stats"
"Youri Tielemans","Leicester City",2019,"be BEL","MF",21,1997,12.1,17,8,5,9,3,5,17,29.4,12,13,2,11,5,22,13,1,"Matches","https://fbref.com/en/comps/9/2018-2019/defense/2018-2019-Premier-League-Stats"
"James Tomkins","Crystal Palace",2019,"eng ENG","DF",29,1989,28.4,34,20,27,7,0,15,28,53.6,13,23,10,13,34,68,184,3,"Matches","https://fbref.com/en/comps/9/2018-2019/defense/2018-2019-Premier-League-Stats"
"Lucas Torreira","Arsenal",2019,"uy URU","MF",22,1996,26.5,65,39,24,32,9,25,57,43.9,32,34,7,27,41,106,33,2,"Matches","https://fbref.com/en/comps/9/2018-2019/defense/2018-2019-Premier-League-Stats"
"Cenk Tosun","Everton",2019,"tr TUR","FW",27,1991,11.8,13,9,3,6,4,4,13,30.8,9,12,0,12,5,18,3,0,"Matches","https://fbref.com/en/comps/9/2018-2019/defense/2018-2019-Premier-League-Stats"
"Andros Townsend","Crystal Palace",2019,"eng ENG","FW,MF",27,1991,33.4,62,35,38,16,8,35,89,39.3,54,48,5,43,38,100,28,0,"Matches","https://fbref.com/en/comps/9/2018-2019/defense/2018-2019-Premier-League-Stats"
"Adama Traoré","Wolves",2019,"es ESP","FW,MF",22,1996,10,16,13,11,3,2,4,9,44.4,5,11,0,11,6,22,7,0,"Matches","https://fbref.com/en/comps/9/2018-2019/defense/2018-2019-Premier-League-Stats"
"Mark Travers","Bournemouth",2019,"ie IRL","GK",19,1999,2,0,0,0,0,0,0,0,NA,0,0,0,0,0,0,2,0,"Matches","https://fbref.com/en/comps/9/2018-2019/defense/2018-2019-Premier-League-Stats"
"Kieran Trippier","Tottenham",2019,"eng ENG","DF",27,1990,25.3,67,37,43,16,8,37,62,59.7,25,38,5,33,23,90,77,2,"Matches","https://fbref.com/en/comps/9/2018-2019/defense/2018-2019-Premier-League-Stats"
"Antonio Valencia","Manchester Utd",2019,"ec ECU","DF",32,1985,5.2,8,6,2,4,2,3,4,75,1,9,0,9,5,13,10,0,"Matches","https://fbref.com/en/comps/9/2018-2019/defense/2018-2019-Premier-League-Stats"
"Yan Valery","Southampton",2019,"tn TUN","DF",19,1999,19,42,36,26,10,6,16,29,55.2,13,24,3,21,22,64,72,1,"Matches","https://fbref.com/en/comps/9/2018-2019/defense/2018-2019-Premier-League-Stats"
"Virgil van Dijk","Liverpool",2019,"nl NED","DF",27,1991,37.6,38,28,26,11,1,14,14,100,0,29,18,11,40,78,201,1,"Matches","https://fbref.com/en/comps/9/2018-2019/defense/2018-2019-Premier-League-Stats"
"Jamie Vardy","Leicester City",2019,"eng ENG","FW",31,1987,30.3,14,8,3,6,5,4,17,23.5,13,16,1,15,6,20,28,0,"Matches","https://fbref.com/en/comps/9/2018-2019/defense/2018-2019-Premier-League-Stats"
"Jan Vertonghen","Tottenham",2019,"be BEL","DF",31,1987,21.2,39,24,17,20,2,14,24,58.3,10,18,11,7,32,71,81,0,"Matches","https://fbref.com/en/comps/9/2018-2019/defense/2018-2019-Premier-League-Stats"
"Jannik Vestergaard","Southampton",2019,"dk DEN","DF",25,1992,22.5,53,33,37,13,3,28,45,62.2,17,35,20,15,35,88,174,1,"Matches","https://fbref.com/en/comps/9/2018-2019/defense/2018-2019-Premier-League-Stats"
"Luciano Vietto","Fulham",2019,"ar ARG","FW,MF",24,1993,11,15,11,5,5,5,4,19,21.1,15,9,0,9,6,21,5,0,"Matches","https://fbref.com/en/comps/9/2018-2019/defense/2018-2019-Premier-League-Stats"
"Rúben Vinagre","Wolves",2019,"pt POR","DF,MF",19,1999,7.9,14,9,7,7,0,2,5,40,3,10,2,8,14,28,16,1,"Matches","https://fbref.com/en/comps/9/2018-2019/defense/2018-2019-Premier-League-Stats"
"Sam Vokes","Burnley",2019,"wls WAL","FW",28,1989,10.2,4,2,1,2,1,0,0,NA,0,2,1,1,0,4,17,0,"Matches","https://fbref.com/en/comps/9/2018-2019/defense/2018-2019-Premier-League-Stats"
"Michel Vorm","Tottenham",2019,"nl NED","GK",34,1983,2,0,0,0,0,0,0,0,NA,0,0,0,0,0,0,1,0,"Matches","https://fbref.com/en/comps/9/2018-2019/defense/2018-2019-Premier-League-Stats"
"Matej Vydra","Burnley",2019,"cz CZE","FW",26,1992,3.5,2,1,0,1,1,0,3,0,3,4,1,3,1,3,6,0,"Matches","https://fbref.com/en/comps/9/2018-2019/defense/2018-2019-Premier-League-Stats"
"Theo Walcott","Everton",2019,"eng ENG","FW,MF",29,1989,23.5,27,17,11,9,7,10,22,45.5,12,17,1,16,22,49,8,0,"Matches","https://fbref.com/en/comps/9/2018-2019/defense/2018-2019-Premier-League-Stats"
"Kyle Walker","Manchester City",2019,"eng ENG","DF",28,1990,30.9,40,26,20,20,0,24,38,63.2,14,19,5,14,36,76,58,2,"Matches","https://fbref.com/en/comps/9/2018-2019/defense/2018-2019-Premier-League-Stats"
"Kyle Walker-Peters","Tottenham",2019,"eng ENG","DF",21,1997,4.2,7,4,4,2,1,3,4,75,1,5,1,4,4,11,6,0,"Matches","https://fbref.com/en/comps/9/2018-2019/defense/2018-2019-Premier-League-Stats"
"Aaron Wan-Bissaka","Crystal Palace",2019,"eng ENG","DF",20,1997,34.8,129,90,90,33,6,55,65,84.6,10,49,16,33,84,213,161,0,"Matches","https://fbref.com/en/comps/9/2018-2019/defense/2018-2019-Premier-League-Stats"
"Victor Wanyama","Tottenham",2019,"ke KEN","MF",27,1991,5.7,13,13,8,5,0,6,12,50,6,9,3,6,7,20,11,0,"Matches","https://fbref.com/en/comps/9/2018-2019/defense/2018-2019-Premier-League-Stats"
"Danny Ward","Cardiff City",2019,"eng ENG","FW",26,1991,4.9,2,1,0,1,1,0,3,0,3,3,1,2,0,2,9,0,"Matches","https://fbref.com/en/comps/9/2018-2019/defense/2018-2019-Premier-League-Stats"
"Joel Ward","Crystal Palace",2019,"eng ENG","DF",28,1989,6.1,12,7,7,4,1,3,10,30,7,2,0,2,10,22,35,0,"Matches","https://fbref.com/en/comps/9/2018-2019/defense/2018-2019-Premier-League-Stats"
"Stephen Ward","Burnley",2019,"ie IRL","DF",32,1985,2.5,4,2,1,2,1,1,4,25,3,3,1,2,4,8,14,0,"Matches","https://fbref.com/en/comps/9/2018-2019/defense/2018-2019-Premier-League-Stats"
"James Ward-Prowse","Southampton",2019,"eng ENG","MF,DF",23,1994,21.6,36,17,19,13,4,14,43,32.6,29,30,6,24,27,63,59,0,"Matches","https://fbref.com/en/comps/9/2018-2019/defense/2018-2019-Premier-League-Stats"
"Danny Welbeck","Arsenal",2019,"eng ENG","FW,MF",27,1990,1.7,3,2,0,2,1,0,0,NA,0,2,0,2,1,4,2,0,"Matches","https://fbref.com/en/comps/9/2018-2019/defense/2018-2019-Premier-League-Stats"
"Ashley Westwood","Burnley",2019,"eng ENG","MF",28,1990,31.4,58,30,24,27,7,14,39,35.9,25,38,9,29,47,105,42,2,"Matches","https://fbref.com/en/comps/9/2018-2019/defense/2018-2019-Premier-League-Stats"
"Connor Wickham","Crystal Palace",2019,"eng ENG","FW,MF",25,1993,0.7,0,0,0,0,0,0,0,NA,0,0,0,0,0,0,2,0,"Matches","https://fbref.com/en/comps/9/2018-2019/defense/2018-2019-Premier-League-Stats"
"Georginio Wijnaldum","Liverpool",2019,"nl NED","MF",27,1990,30.3,41,28,14,20,7,14,27,51.9,13,21,7,14,21,62,24,0,"Matches","https://fbref.com/en/comps/9/2018-2019/defense/2018-2019-Premier-League-Stats"
"Danny Williams","Huddersfield",2019,"us USA","MF",29,1989,1.1,0,0,0,0,0,0,0,NA,0,4,1,3,1,1,2,0,"Matches","https://fbref.com/en/comps/9/2018-2019/defense/2018-2019-Premier-League-Stats"
"Willian","Chelsea",2019,"br BRA","FW",29,1988,23.3,35,21,11,15,9,9,25,36,16,16,1,15,14,49,12,2,"Matches","https://fbref.com/en/comps/9/2018-2019/defense/2018-2019-Premier-League-Stats"
"Joe Willock","Arsenal",2019,"eng ENG","MF,FW",18,1999,0.7,1,0,0,1,0,0,0,NA,0,1,0,1,1,2,0,0,"Matches","https://fbref.com/en/comps/9/2018-2019/defense/2018-2019-Premier-League-Stats"
"Ben Wilmot","Watford",2019,"eng ENG","MF,DF",18,1999,0.3,0,0,0,0,0,0,1,0,1,2,1,1,0,0,1,0,"Matches","https://fbref.com/en/comps/9/2018-2019/defense/2018-2019-Premier-League-Stats"
"Jack Wilshere","West Ham",2019,"eng ENG","MF",26,1992,4.4,7,4,1,4,2,2,6,33.3,4,3,1,2,7,14,0,0,"Matches","https://fbref.com/en/comps/9/2018-2019/defense/2018-2019-Premier-League-Stats"
"Callum Wilson","Bournemouth",2019,"eng ENG","FW",26,1992,28.1,9,7,4,3,2,0,8,0,8,14,4,10,4,13,16,0,"Matches","https://fbref.com/en/comps/9/2018-2019/defense/2018-2019-Premier-League-Stats"
"Harry Winks","Tottenham",2019,"eng ENG","MF",22,1996,17.7,22,13,12,9,1,5,30,16.7,25,19,3,16,21,43,19,0,"Matches","https://fbref.com/en/comps/9/2018-2019/defense/2018-2019-Premier-League-Stats"
"Chris Wood","Burnley",2019,"nz NZL","FW",26,1991,28.8,12,8,0,7,5,5,17,29.4,12,17,4,13,3,15,26,0,"Matches","https://fbref.com/en/comps/9/2018-2019/defense/2018-2019-Premier-League-Stats"
"Granit Xhaka","Arsenal",2019,"ch SUI","MF,DF",25,1992,27.8,52,29,29,20,3,24,59,40.7,35,35,9,26,36,88,56,3,"Matches","https://fbref.com/en/comps/9/2018-2019/defense/2018-2019-Premier-League-Stats"
"Andriy Yarmolenko","West Ham",2019,"ua UKR","MF,FW",28,1989,5.1,4,1,2,1,1,4,6,66.7,2,4,1,3,2,6,4,2,"Matches","https://fbref.com/en/comps/9/2018-2019/defense/2018-2019-Premier-League-Stats"
"DeAndre Yedlin","Newcastle Utd",2019,"us USA","DF",25,1993,27.5,54,32,36,14,4,19,41,46.3,22,36,10,26,28,82,88,0,"Matches","https://fbref.com/en/comps/9/2018-2019/defense/2018-2019-Premier-League-Stats"
"Maya Yoshida","Southampton",2019,"jp JPN","DF",29,1988,16.9,16,12,5,10,1,4,13,30.8,9,24,20,4,42,58,103,1,"Matches","https://fbref.com/en/comps/9/2018-2019/defense/2018-2019-Premier-League-Stats"
"Ashley Young","Manchester Utd",2019,"eng ENG","DF",33,1985,28.5,52,32,34,16,2,20,39,51.3,19,36,10,26,55,107,74,0,"Matches","https://fbref.com/en/comps/9/2018-2019/defense/2018-2019-Premier-League-Stats"
"Pablo Zabaleta","West Ham",2019,"ar ARG","DF",33,1985,23.2,47,24,26,15,6,17,44,38.6,27,39,15,24,48,95,96,3,"Matches","https://fbref.com/en/comps/9/2018-2019/defense/2018-2019-Premier-League-Stats"
"Wilfried Zaha","Crystal Palace",2019,"ci CIV","FW",25,1992,33.7,39,20,11,23,5,12,34,35.3,22,19,0,19,10,49,4,0,"Matches","https://fbref.com/en/comps/9/2018-2019/defense/2018-2019-Premier-League-Stats"
"Andre-Frank Zambo Anguissa","Fulham",2019,"cm CMR","MF",22,1995,16.9,48,29,23,20,5,18,52,34.6,34,25,6,19,34,82,32,0,"Matches","https://fbref.com/en/comps/9/2018-2019/defense/2018-2019-Premier-League-Stats"
"Davide Zappacosta","Chelsea",2019,"it ITA","DF",26,1992,1.4,0,0,0,0,0,0,1,0,1,0,0,0,3,3,5,0,"Matches","https://fbref.com/en/comps/9/2018-2019/defense/2018-2019-Premier-League-Stats"
"Oleksandr Zinchenko","Manchester City",2019,"ua UKR","DF",21,1996,12.8,34,20,13,15,6,14,33,42.4,19,14,3,11,20,54,19,1,"Matches","https://fbref.com/en/comps/9/2018-2019/defense/2018-2019-Premier-League-Stats"
"Kenneth Zohore","Cardiff City",2019,"dk DEN","FW",24,1994,8.4,3,2,0,3,0,1,3,33.3,2,4,2,2,2,5,5,0,"Matches","https://fbref.com/en/comps/9/2018-2019/defense/2018-2019-Premier-League-Stats"
"Kurt Zouma","Everton",2019,"fr FRA","DF",23,1994,29,32,21,16,14,2,4,11,36.4,7,27,12,15,54,86,126,2,"Matches","https://fbref.com/en/comps/9/2018-2019/defense/2018-2019-Premier-League-Stats"
