"Player","Squad","Season","Nation","Pos","Age","Born","Mins_Per_90","Tkl_Tackles","TklW_Tackles","Def 3rd_Tackles","Mid 3rd_Tackles","Att 3rd_Tackles","Tkl_Challenges","Att_Challenges","Tkl_percent_Challenges","Lost_Challenges","Blocks_Blocks","Sh_Blocks","Pass_Blocks","Int","Tkl+Int","Clr","Err","Matches","url"
"Patrick van Aanholt","Crystal Palace",2018,"nl NED","DF",26,1990,24.3,47,32,29,15,3,16,34,47.1,18,24,5,19,47,94,64,2,"Matches","https://fbref.com/en/comps/9/2017-2018/defense/2017-2018-Premier-League-Stats"
"Rolando Aarons","Newcastle Utd",2018,"eng ENG","MF,FW",21,1995,1.5,4,4,3,1,0,4,6,66.7,2,3,0,3,1,5,0,0,"Matches","https://fbref.com/en/comps/9/2017-2018/defense/2017-2018-Premier-League-Stats"
"Tammy Abraham","Swansea City",2018,"eng ENG","FW",19,1997,19.2,10,8,1,7,2,1,13,7.7,12,8,1,7,1,11,11,0,"Matches","https://fbref.com/en/comps/9/2017-2018/defense/2017-2018-Premier-League-Stats"
"Charlie Adam","Stoke City",2018,"sct SCO","MF",31,1985,4.6,9,5,2,5,2,5,17,29.4,12,2,0,2,9,18,11,2,"Matches","https://fbref.com/en/comps/9/2017-2018/defense/2017-2018-Premier-League-Stats"
"Adrián","West Ham",2018,"es ESP","GK",30,1987,19,2,1,2,0,0,1,4,25,3,1,0,1,0,2,15,1,"Matches","https://fbref.com/en/comps/9/2017-2018/defense/2017-2018-Premier-League-Stats"
"Ibrahim Afellay","Stoke City",2018,"nl NED","MF",31,1986,1.8,3,3,0,3,0,1,2,50,1,1,0,1,1,4,1,0,"Matches","https://fbref.com/en/comps/9/2017-2018/defense/2017-2018-Premier-League-Stats"
"Benik Afobe","Bournemouth",2018,"cd COD","FW",24,1993,6.8,4,3,1,2,1,1,6,16.7,5,4,0,4,0,4,6,0,"Matches","https://fbref.com/en/comps/9/2017-2018/defense/2017-2018-Premier-League-Stats"
"Sergio Agüero","Manchester City",2018,"ar ARG","FW",29,1988,21.8,9,6,2,6,1,2,17,11.8,15,12,1,11,6,15,3,0,"Matches","https://fbref.com/en/comps/9/2017-2018/defense/2017-2018-Premier-League-Stats"
"Nathan Aké","Bournemouth",2018,"nl NED","DF",22,1995,37.3,53,32,34,16,3,22,40,55,18,47,24,23,48,101,246,2,"Matches","https://fbref.com/en/comps/9/2017-2018/defense/2017-2018-Premier-League-Stats"
"Marc Albrighton","Leicester City",2018,"eng ENG","MF,FW",27,1989,28.2,52,33,16,29,7,16,52,30.8,36,32,4,28,27,79,34,0,"Matches","https://fbref.com/en/comps/9/2017-2018/defense/2017-2018-Premier-League-Stats"
"Toby Alderweireld","Tottenham",2018,"be BEL","DF",28,1989,13.1,19,13,7,11,1,8,15,53.3,7,11,5,6,4,23,55,0,"Matches","https://fbref.com/en/comps/9/2017-2018/defense/2017-2018-Premier-League-Stats"
"Trent Alexander-Arnold","Liverpool",2018,"eng ENG","DF",18,1998,17.5,37,25,23,9,5,22,36,61.1,14,20,5,15,28,65,46,1,"Matches","https://fbref.com/en/comps/9/2017-2018/defense/2017-2018-Premier-League-Stats"
"Joe Allen","Stoke City",2018,"wls WAL","MF",27,1990,34.9,96,62,41,43,12,27,87,31,60,43,9,34,58,154,68,1,"Matches","https://fbref.com/en/comps/9/2017-2018/defense/2017-2018-Premier-League-Stats"
"Dele Alli","Tottenham",2018,"eng ENG","MF,FW",21,1996,32.9,46,30,15,21,10,8,34,23.5,26,33,7,26,19,65,22,1,"Matches","https://fbref.com/en/comps/9/2017-2018/defense/2017-2018-Premier-League-Stats"
"Marcos Alonso","Chelsea",2018,"es ESP","DF,MF",26,1990,31.7,51,33,30,18,3,23,44,52.3,21,36,5,31,47,98,76,1,"Matches","https://fbref.com/en/comps/9/2017-2018/defense/2017-2018-Premier-League-Stats"
"Daniel Amartey","Leicester City",2018,"gh GHA","DF",22,1994,5.4,8,4,7,1,0,3,7,42.9,4,7,3,4,7,15,21,1,"Matches","https://fbref.com/en/comps/9/2017-2018/defense/2017-2018-Premier-League-Stats"
"Ethan Ampadu","Chelsea",2018,"wls WAL","DF",16,2000,0.1,1,1,0,1,0,0,0,NA,0,0,0,0,0,1,2,0,"Matches","https://fbref.com/en/comps/9/2017-2018/defense/2017-2018-Premier-League-Stats"
"Nordin Amrabat","Watford",2018,"ma MAR","FW",30,1987,2.2,6,3,1,5,0,1,3,33.3,2,1,0,1,0,6,2,0,"Matches","https://fbref.com/en/comps/9/2017-2018/defense/2017-2018-Premier-League-Stats"
"Michail Antonio","West Ham",2018,"jm JAM","FW,MF",27,1990,15,15,9,7,6,2,4,14,28.6,10,14,0,14,13,28,16,0,"Matches","https://fbref.com/en/comps/9/2017-2018/defense/2017-2018-Premier-League-Stats"
"Scott Arfield","Burnley",2018,"ca CAN","MF,FW",28,1988,14.8,36,26,20,13,3,19,44,43.2,25,22,1,21,11,47,24,0,"Matches","https://fbref.com/en/comps/9/2017-2018/defense/2017-2018-Premier-League-Stats"
"Marko Arnautovic","West Ham",2018,"at AUT","FW,MF",28,1989,25.7,21,16,9,8,4,7,19,36.8,12,20,3,17,13,34,35,0,"Matches","https://fbref.com/en/comps/9/2017-2018/defense/2017-2018-Premier-League-Stats"
"Harry Arter","Bournemouth",2018,"ie IRL","MF",27,1989,10.7,19,16,10,7,2,6,23,26.1,17,18,5,13,9,28,6,0,"Matches","https://fbref.com/en/comps/9/2017-2018/defense/2017-2018-Premier-League-Stats"
"Christian Atsu","Newcastle Utd",2018,"gh GHA","FW,MF",25,1992,19.8,17,16,10,7,0,7,20,35,13,35,5,30,13,30,27,1,"Matches","https://fbref.com/en/comps/9/2017-2018/defense/2017-2018-Premier-League-Stats"
"Pierre-Emerick Aubameyang","Arsenal",2018,"ga GAB","FW",28,1989,11.7,5,4,3,2,0,1,7,14.3,6,14,1,13,3,8,7,0,"Matches","https://fbref.com/en/comps/9/2017-2018/defense/2017-2018-Premier-League-Stats"
"Serge Aurier","Tottenham",2018,"ci CIV","DF",24,1992,15.9,48,27,27,13,8,11,31,35.5,20,20,1,19,31,79,54,1,"Matches","https://fbref.com/en/comps/9/2017-2018/defense/2017-2018-Premier-League-Stats"
"Charlie Austin","Southampton",2018,"eng ENG","FW",28,1989,11.5,7,5,1,3,3,3,10,30,7,15,3,12,1,8,10,0,"Matches","https://fbref.com/en/comps/9/2017-2018/defense/2017-2018-Premier-League-Stats"
"André Ayew","West Ham",2018,"gh GHA","MF,FW",27,1989,9.9,19,14,6,10,3,6,19,31.6,13,5,0,5,4,23,3,0,"Matches","https://fbref.com/en/comps/9/2017-2018/defense/2017-2018-Premier-League-Stats"
"André Ayew","Swansea City",2018,"gh GHA","MF,FW",27,1989,10.6,15,10,3,10,2,2,13,15.4,11,13,1,12,5,20,8,0,"Matches","https://fbref.com/en/comps/9/2017-2018/defense/2017-2018-Premier-League-Stats"
"Jordan Ayew","Swansea City",2018,"gh GHA","FW,MF",25,1991,31.7,82,60,20,35,27,15,54,27.8,39,43,3,40,24,106,20,1,"Matches","https://fbref.com/en/comps/9/2017-2018/defense/2017-2018-Premier-League-Stats"
"César Azpilicueta","Chelsea",2018,"es ESP","DF",27,1989,37,80,59,47,26,7,27,54,50,27,48,22,26,54,134,135,1,"Matches","https://fbref.com/en/comps/9/2017-2018/defense/2017-2018-Premier-League-Stats"
"Eric Bailly","Manchester Utd",2018,"ci CIV","DF",23,1994,11.1,17,10,10,5,2,5,12,41.7,7,11,6,5,25,42,58,1,"Matches","https://fbref.com/en/comps/9/2017-2018/defense/2017-2018-Premier-League-Stats"
"Leighton Baines","Everton",2018,"eng ENG","DF",32,1984,21.2,25,13,18,3,4,9,14,64.3,5,18,6,12,25,50,56,0,"Matches","https://fbref.com/en/comps/9/2017-2018/defense/2017-2018-Premier-League-Stats"
"Tiemoué Bakayoko","Chelsea",2018,"fr FRA","MF",22,1994,23.6,64,41,25,32,7,16,48,33.3,32,23,6,17,37,101,38,4,"Matches","https://fbref.com/en/comps/9/2017-2018/defense/2017-2018-Premier-League-Stats"
"Sam Baldock","Brighton",2018,"eng ENG","FW",28,1989,0.4,0,0,0,0,0,0,0,NA,0,0,0,0,0,0,0,0,"Matches","https://fbref.com/en/comps/9/2017-2018/defense/2017-2018-Premier-League-Stats"
"Beni Baningime","Everton",2018,"cd COD","MF",18,1998,2.2,6,2,1,2,3,0,4,0,4,5,1,4,2,8,2,0,"Matches","https://fbref.com/en/comps/9/2017-2018/defense/2017-2018-Premier-League-Stats"
"Phil Bardsley","Burnley",2018,"sct SCO","DF",32,1985,12.5,17,16,9,7,1,4,11,36.4,7,22,6,16,22,39,77,0,"Matches","https://fbref.com/en/comps/9/2017-2018/defense/2017-2018-Premier-League-Stats"
"Ross Barkley","Chelsea",2018,"eng ENG","MF",23,1993,1.4,0,0,0,0,0,0,1,0,1,3,1,2,0,0,2,0,"Matches","https://fbref.com/en/comps/9/2017-2018/defense/2017-2018-Premier-League-Stats"
"Ashley Barnes","Burnley",2018,"eng ENG","FW",27,1989,24.1,21,14,1,14,6,5,29,17.2,24,26,5,21,2,23,19,0,"Matches","https://fbref.com/en/comps/9/2017-2018/defense/2017-2018-Premier-League-Stats"
"Harvey Barnes","Leicester City",2018,"eng ENG","MF,FW",19,1997,0.1,0,0,0,0,0,0,0,NA,0,0,0,0,0,0,0,0,"Matches","https://fbref.com/en/comps/9/2017-2018/defense/2017-2018-Premier-League-Stats"
"Gareth Barry","West Brom",2018,"eng ENG","MF",36,1981,21.4,35,19,17,14,4,15,45,33.3,30,19,11,8,14,49,34,0,"Matches","https://fbref.com/en/comps/9/2017-2018/defense/2017-2018-Premier-League-Stats"
"Kyle Bartley","Swansea City",2018,"eng ENG","DF",26,1991,2.6,3,2,3,0,0,2,2,100,0,6,6,0,4,7,21,0,"Matches","https://fbref.com/en/comps/9/2017-2018/defense/2017-2018-Premier-League-Stats"
"Michy Batshuayi","Chelsea",2018,"be BEL","FW",23,1993,4,5,4,2,3,0,1,3,33.3,2,0,0,0,1,6,3,0,"Matches","https://fbref.com/en/comps/9/2017-2018/defense/2017-2018-Premier-League-Stats"
"Moritz Bauer","Stoke City",2018,"at AUT","DF,MF",25,1992,14.5,24,17,17,7,0,10,26,38.5,16,9,1,8,12,36,48,0,"Matches","https://fbref.com/en/comps/9/2017-2018/defense/2017-2018-Premier-League-Stats"
"Jan Bednarek","Southampton",2018,"pl POL","DF",21,1996,4.7,6,3,6,0,0,3,6,50,3,2,1,1,5,11,27,0,"Matches","https://fbref.com/en/comps/9/2017-2018/defense/2017-2018-Premier-League-Stats"
"Asmir Begovic","Bournemouth",2018,"ba BIH","GK",30,1987,38,0,0,0,0,0,0,2,0,2,0,0,0,2,2,16,7,"Matches","https://fbref.com/en/comps/9/2017-2018/defense/2017-2018-Premier-League-Stats"
"Héctor Bellerín","Arsenal",2018,"es ESP","DF",22,1995,33.9,57,43,36,12,9,25,52,48.1,27,42,8,34,23,80,89,4,"Matches","https://fbref.com/en/comps/9/2017-2018/defense/2017-2018-Premier-League-Stats"
"Yohan Benalouane","Leicester City",2018,"tn TUN","DF",30,1987,1,7,3,6,1,0,4,6,66.7,2,1,1,0,1,8,4,0,"Matches","https://fbref.com/en/comps/9/2017-2018/defense/2017-2018-Premier-League-Stats"
"Christian Benteke","Crystal Palace",2018,"be BEL","FW",26,1990,24.9,11,4,3,7,1,2,17,11.8,15,15,3,12,3,14,44,0,"Matches","https://fbref.com/en/comps/9/2017-2018/defense/2017-2018-Premier-League-Stats"
"Saido Berahino","Stoke City",2018,"bi BDI","FW",23,1993,5.5,2,2,0,1,1,0,1,0,1,4,1,3,1,3,2,0,"Matches","https://fbref.com/en/comps/9/2017-2018/defense/2017-2018-Premier-League-Stats"
"Jóhann Berg Guðmundsson","Burnley",2018,"is ISL","MF",26,1990,31.5,43,27,16,19,8,20,47,42.6,27,21,1,20,34,77,43,0,"Matches","https://fbref.com/en/comps/9/2017-2018/defense/2017-2018-Premier-League-Stats"
"Ryan Bertrand","Southampton",2018,"eng ENG","DF",27,1989,34.8,48,35,27,17,4,19,31,61.3,12,28,9,19,44,92,74,0,"Matches","https://fbref.com/en/comps/9/2017-2018/defense/2017-2018-Premier-League-Stats"
"Muhamed Beic","Everton",2018,"ba BIH","MF",24,1992,0.5,1,1,1,0,0,1,3,33.3,2,2,2,0,0,1,1,0,"Matches","https://fbref.com/en/comps/9/2017-2018/defense/2017-2018-Premier-League-Stats"
"Philip Billing","Huddersfield",2018,"dk DEN","MF",21,1996,8.5,25,16,11,11,3,8,22,36.4,14,17,1,16,18,43,19,0,"Matches","https://fbref.com/en/comps/9/2017-2018/defense/2017-2018-Premier-League-Stats"
"Mame Biram Diouf","Stoke City",2018,"sn SEN","FW,DF",29,1987,28.8,48,36,26,15,7,8,21,38.1,13,22,0,22,14,62,76,1,"Matches","https://fbref.com/en/comps/9/2017-2018/defense/2017-2018-Premier-League-Stats"
"Daley Blind","Manchester Utd",2018,"nl NED","DF,MF",27,1990,4,6,4,3,2,1,2,7,28.6,5,3,0,3,7,13,14,0,"Matches","https://fbref.com/en/comps/9/2017-2018/defense/2017-2018-Premier-League-Stats"
"Jeremie Boga","Chelsea",2018,"ci CIV","MF",20,1997,0.2,0,0,0,0,0,0,0,NA,0,0,0,0,0,0,0,0,"Matches","https://fbref.com/en/comps/9/2017-2018/defense/2017-2018-Premier-League-Stats"
"Yannick Bolasie","Everton",2018,"cd COD","FW",28,1989,9.5,8,7,4,1,3,2,7,28.6,5,5,0,5,4,12,8,0,"Matches","https://fbref.com/en/comps/9/2017-2018/defense/2017-2018-Premier-League-Stats"
"Gaëtan Bong","Brighton",2018,"cm CMR","DF",29,1988,24.8,39,32,25,11,3,15,26,57.7,11,24,6,18,40,79,81,1,"Matches","https://fbref.com/en/comps/9/2017-2018/defense/2017-2018-Premier-League-Stats"
"Wilfried Bony","Swansea City",2018,"ci CIV","FW",28,1988,7.9,5,4,2,2,1,1,5,20,4,4,1,3,2,7,15,0,"Matches","https://fbref.com/en/comps/9/2017-2018/defense/2017-2018-Premier-League-Stats"
"Sofiane Boufal","Southampton",2018,"ma MAR","FW,MF",23,1993,13.5,37,24,12,14,11,12,35,34.3,23,20,1,19,6,43,6,0,"Matches","https://fbref.com/en/comps/9/2017-2018/defense/2017-2018-Premier-League-Stats"
"Robbie Brady","Burnley",2018,"ie IRL","MF",25,1992,14.2,32,21,14,17,1,8,28,28.6,20,17,3,14,7,39,29,0,"Matches","https://fbref.com/en/comps/9/2017-2018/defense/2017-2018-Premier-League-Stats"
"Claudio Bravo","Manchester City",2018,"cl CHI","GK",34,1983,2.5,0,0,0,0,0,0,1,0,1,0,0,0,0,0,0,0,"Matches","https://fbref.com/en/comps/9/2017-2018/defense/2017-2018-Premier-League-Stats"
"Miguel Britos","Watford",2018,"uy URU","DF",32,1985,8.9,15,11,10,5,0,6,11,54.5,5,9,1,8,12,27,45,1,"Matches","https://fbref.com/en/comps/9/2017-2018/defense/2017-2018-Premier-League-Stats"
"Leon Britton","Swansea City",2018,"eng ENG","MF",34,1982,3.4,6,5,0,5,1,5,8,62.5,3,3,1,2,1,7,1,0,"Matches","https://fbref.com/en/comps/9/2017-2018/defense/2017-2018-Premier-League-Stats"
"Izzy Brown","Brighton",2018,"eng ENG","MF,FW",20,1997,3.5,3,3,2,1,0,1,7,14.3,6,3,0,3,1,4,3,0,"Matches","https://fbref.com/en/comps/9/2017-2018/defense/2017-2018-Premier-League-Stats"
"Bruno","Brighton",2018,"es ESP","DF",36,1980,22.4,30,17,21,6,3,14,22,63.6,8,17,11,6,38,68,76,0,"Matches","https://fbref.com/en/comps/9/2017-2018/defense/2017-2018-Premier-League-Stats"
"Chris Brunt","West Brom",2018,"nir NIR","MF,DF",32,1984,21.3,41,24,19,21,1,11,31,35.5,20,28,4,24,22,63,45,1,"Matches","https://fbref.com/en/comps/9/2017-2018/defense/2017-2018-Premier-League-Stats"
"Oliver Burke","West Brom",2018,"sct SCO","FW,MF",20,1997,4.1,6,4,3,2,1,4,12,33.3,8,3,0,3,7,13,3,0,"Matches","https://fbref.com/en/comps/9/2017-2018/defense/2017-2018-Premier-League-Stats"
"Jack Butland","Stoke City",2018,"eng ENG","GK",24,1993,35,1,1,1,0,0,1,1,100,0,1,0,1,1,2,26,1,"Matches","https://fbref.com/en/comps/9/2017-2018/defense/2017-2018-Premier-League-Stats"
"Sam Byram","West Ham",2018,"eng ENG","DF,MF",23,1993,2.8,9,5,6,3,0,4,9,44.4,5,6,2,4,9,18,16,0,"Matches","https://fbref.com/en/comps/9/2017-2018/defense/2017-2018-Premier-League-Stats"
"Willy Caballero","Chelsea",2018,"ar ARG","GK",35,1981,3,0,0,0,0,0,0,0,NA,0,0,0,0,0,0,3,0,"Matches","https://fbref.com/en/comps/9/2017-2018/defense/2017-2018-Premier-League-Stats"
"Yohan Cabaye","Crystal Palace",2018,"fr FRA","MF",31,1986,26.4,70,44,39,28,3,24,97,24.7,73,47,4,43,79,149,29,4,"Matches","https://fbref.com/en/comps/9/2017-2018/defense/2017-2018-Premier-League-Stats"
"Gary Cahill","Chelsea",2018,"eng ENG","DF",31,1985,23.2,29,21,15,9,5,10,21,47.6,11,21,14,7,27,56,127,1,"Matches","https://fbref.com/en/comps/9/2017-2018/defense/2017-2018-Premier-League-Stats"
"Dominic Calvert-Lewin","Everton",2018,"eng ENG","FW",20,1997,20.9,15,8,5,3,7,2,15,13.3,13,13,1,12,10,25,23,1,"Matches","https://fbref.com/en/comps/9/2017-2018/defense/2017-2018-Premier-League-Stats"
"Geoff Cameron","Stoke City",2018,"us USA","DF,MF",32,1985,16.9,34,21,20,12,2,11,27,40.7,16,28,8,20,36,70,68,0,"Matches","https://fbref.com/en/comps/9/2017-2018/defense/2017-2018-Premier-League-Stats"
"Tyrese Campbell","Stoke City",2018,"eng ENG","FW",17,1999,0.9,2,1,0,2,0,1,1,100,0,1,1,0,1,3,0,0,"Matches","https://fbref.com/en/comps/9/2017-2018/defense/2017-2018-Premier-League-Stats"
"Emre Can","Liverpool",2018,"de GER","MF",23,1994,23.2,67,54,32,29,6,18,43,41.9,25,32,4,28,28,95,37,1,"Matches","https://fbref.com/en/comps/9/2017-2018/defense/2017-2018-Premier-League-Stats"
"Étienne Capoue","Watford",2018,"fr FRA","MF",29,1988,17.1,43,26,15,25,3,19,47,40.4,28,21,1,20,43,86,38,0,"Matches","https://fbref.com/en/comps/9/2017-2018/defense/2017-2018-Premier-League-Stats"
"Michael Carrick","Manchester Utd",2018,"eng ENG","MF",36,1981,1.2,1,1,0,1,0,0,1,0,1,2,0,2,1,2,3,0,"Matches","https://fbref.com/en/comps/9/2017-2018/defense/2017-2018-Premier-League-Stats"
"André Carrillo","Watford",2018,"pe PER","FW,MF",26,1991,17.1,31,24,16,12,3,8,33,24.2,25,7,0,7,15,46,16,0,"Matches","https://fbref.com/en/comps/9/2017-2018/defense/2017-2018-Premier-League-Stats"
"Guido Carrillo","Southampton",2018,"ar ARG","FW",26,1991,5,5,1,0,3,2,0,1,0,1,4,0,4,0,5,5,0,"Matches","https://fbref.com/en/comps/9/2017-2018/defense/2017-2018-Premier-League-Stats"
"Andy Carroll","West Ham",2018,"eng ENG","FW",28,1989,8.3,3,3,2,0,1,0,1,0,1,3,2,1,2,5,15,0,"Matches","https://fbref.com/en/comps/9/2017-2018/defense/2017-2018-Premier-League-Stats"
"Tom Carroll","Swansea City",2018,"eng ENG","MF",25,1992,28.6,53,33,22,23,8,14,53,26.4,39,37,8,29,29,82,18,1,"Matches","https://fbref.com/en/comps/9/2017-2018/defense/2017-2018-Premier-League-Stats"
"Craig Cathcart","Watford",2018,"nir NIR","DF",28,1989,5.8,8,5,5,3,0,4,5,80,1,8,6,2,3,11,38,0,"Matches","https://fbref.com/en/comps/9/2017-2018/defense/2017-2018-Premier-League-Stats"
"Petr Cech","Arsenal",2018,"cz CZE","GK",35,1982,33.8,1,1,1,0,0,1,1,100,0,0,0,0,0,1,23,7,"Matches","https://fbref.com/en/comps/9/2017-2018/defense/2017-2018-Premier-League-Stats"
"Nacer Chadli","West Brom",2018,"be BEL","FW,MF",27,1989,2.9,1,0,1,0,0,1,4,25,3,0,0,0,0,1,4,0,"Matches","https://fbref.com/en/comps/9/2017-2018/defense/2017-2018-Premier-League-Stats"
"Nathaniel Chalobah","Watford",2018,"eng ENG","MF",22,1994,5,9,6,2,6,1,2,5,40,3,6,5,1,6,15,6,0,"Matches","https://fbref.com/en/comps/9/2017-2018/defense/2017-2018-Premier-League-Stats"
"Calum Chambers","Arsenal",2018,"eng ENG","DF",22,1995,9.6,17,10,10,6,1,5,14,35.7,9,14,11,3,18,35,47,0,"Matches","https://fbref.com/en/comps/9/2017-2018/defense/2017-2018-Premier-League-Stats"
"Ben Chilwell","Leicester City",2018,"eng ENG","DF",20,1996,20.6,36,26,21,10,5,15,32,46.9,17,31,4,27,28,64,71,3,"Matches","https://fbref.com/en/comps/9/2017-2018/defense/2017-2018-Premier-League-Stats"
"Hamza Choudhury","Leicester City",2018,"eng ENG","MF,DF",19,1997,4.2,9,5,6,3,0,2,10,20,8,12,1,11,8,17,4,0,"Matches","https://fbref.com/en/comps/9/2017-2018/defense/2017-2018-Premier-League-Stats"
"Andreas Christensen","Chelsea",2018,"dk DEN","DF",21,1996,23.2,26,13,23,3,0,10,15,66.7,5,25,17,8,39,65,109,5,"Matches","https://fbref.com/en/comps/9/2017-2018/defense/2017-2018-Premier-League-Stats"
"Lee Chung-yong","Crystal Palace",2018,"kr KOR","FW,MF",29,1988,1.5,2,0,0,1,1,0,0,NA,0,3,0,3,2,4,0,1,"Matches","https://fbref.com/en/comps/9/2017-2018/defense/2017-2018-Premier-League-Stats"
"Ciaran Clark","Newcastle Utd",2018,"ie IRL","DF",27,1989,19.4,25,17,17,8,0,11,21,52.4,10,15,10,5,17,42,144,1,"Matches","https://fbref.com/en/comps/9/2017-2018/defense/2017-2018-Premier-League-Stats"
"Tom Cleverley","Watford",2018,"eng ENG","MF",27,1989,21.1,48,26,25,16,7,21,52,40.4,31,11,1,10,25,73,21,0,"Matches","https://fbref.com/en/comps/9/2017-2018/defense/2017-2018-Premier-League-Stats"
"Sam Clucas","Swansea City",2018,"eng ENG","MF",26,1990,22.7,34,19,21,11,2,10,29,34.5,19,31,7,24,29,63,34,1,"Matches","https://fbref.com/en/comps/9/2017-2018/defense/2017-2018-Premier-League-Stats"
"Nathaniel Clyne","Liverpool",2018,"eng ENG","DF,FW",26,1991,1.9,3,1,2,1,0,0,1,0,1,2,1,1,0,3,3,0,"Matches","https://fbref.com/en/comps/9/2017-2018/defense/2017-2018-Premier-League-Stats"
"Séamus Coleman","Everton",2018,"ie IRL","DF",28,1988,11.5,14,14,9,3,2,6,11,54.5,5,16,12,4,10,24,29,2,"Matches","https://fbref.com/en/comps/9/2017-2018/defense/2017-2018-Premier-League-Stats"
"James Collins","West Ham",2018,"wls WAL","DF",33,1983,11.7,15,9,11,4,0,8,11,72.7,3,13,10,3,16,31,120,1,"Matches","https://fbref.com/en/comps/9/2017-2018/defense/2017-2018-Premier-League-Stats"
"Lewis Cook","Bournemouth",2018,"eng ENG","MF",20,1997,24.9,67,35,37,30,0,26,69,37.7,43,33,12,21,35,102,25,2,"Matches","https://fbref.com/en/comps/9/2017-2018/defense/2017-2018-Premier-League-Stats"
"Steve Cook","Bournemouth",2018,"eng ENG","DF",26,1991,30.7,37,19,28,7,2,19,29,65.5,10,63,45,18,54,91,232,4,"Matches","https://fbref.com/en/comps/9/2017-2018/defense/2017-2018-Premier-League-Stats"
"Francis Coquelin","Arsenal",2018,"fr FRA","MF,DF",26,1991,1.9,5,4,2,3,0,1,3,33.3,2,1,0,1,3,8,2,0,"Matches","https://fbref.com/en/comps/9/2017-2018/defense/2017-2018-Premier-League-Stats"
"Jack Cork","Burnley",2018,"eng ENG","MF",28,1989,38,60,44,25,27,8,20,62,32.3,42,36,15,21,41,101,86,1,"Matches","https://fbref.com/en/comps/9/2017-2018/defense/2017-2018-Premier-League-Stats"
"Thibaut Courtois","Chelsea",2018,"be BEL","GK",25,1992,35,0,0,0,0,0,0,0,NA,0,0,0,0,0,0,8,1,"Matches","https://fbref.com/en/comps/9/2017-2018/defense/2017-2018-Premier-League-Stats"
"Philippe Coutinho","Liverpool",2018,"br BRA","MF,FW",25,1992,12.3,17,14,4,10,3,3,21,14.3,18,10,0,10,10,27,5,1,"Matches","https://fbref.com/en/comps/9/2017-2018/defense/2017-2018-Premier-League-Stats"
"Martin Cranie","Huddersfield",2018,"eng ENG","DF",30,1986,2,3,2,2,1,0,0,1,0,1,3,3,0,1,4,10,0,"Matches","https://fbref.com/en/comps/9/2017-2018/defense/2017-2018-Premier-League-Stats"
"Aaron Cresswell","West Ham",2018,"eng ENG","DF",27,1989,34.1,34,21,12,20,2,19,30,63.3,11,42,17,25,44,78,117,1,"Matches","https://fbref.com/en/comps/9/2017-2018/defense/2017-2018-Premier-League-Stats"
"Peter Crouch","Stoke City",2018,"eng ENG","FW",36,1981,17.4,2,0,0,1,1,0,12,0,12,7,4,3,1,3,31,0,"Matches","https://fbref.com/en/comps/9/2017-2018/defense/2017-2018-Premier-League-Stats"
"Josh Cullen","West Ham",2018,"ie IRL","MF",21,1996,0.1,0,0,0,0,0,0,1,0,1,1,1,0,2,2,0,0,"Matches","https://fbref.com/en/comps/9/2017-2018/defense/2017-2018-Premier-League-Stats"
"Charlie Daniels","Bournemouth",2018,"eng ENG","DF,MF",30,1986,33.4,48,34,32,12,4,22,41,53.7,19,34,7,27,31,79,114,0,"Matches","https://fbref.com/en/comps/9/2017-2018/defense/2017-2018-Premier-League-Stats"
"Danilo","Manchester City",2018,"br BRA","DF",26,1991,15,43,29,25,12,6,19,35,54.3,16,15,6,9,19,62,33,0,"Matches","https://fbref.com/en/comps/9/2017-2018/defense/2017-2018-Premier-League-Stats"
"Scott Dann","Crystal Palace",2018,"eng ENG","DF",30,1987,15.9,10,5,8,2,0,7,17,41.2,10,17,14,3,23,33,98,1,"Matches","https://fbref.com/en/comps/9/2017-2018/defense/2017-2018-Premier-League-Stats"
"Karl Darlow","Newcastle Utd",2018,"eng ENG","GK",26,1990,10,0,0,0,0,0,0,0,NA,0,0,0,0,0,0,3,4,"Matches","https://fbref.com/en/comps/9/2017-2018/defense/2017-2018-Premier-League-Stats"
"Matteo Darmian","Manchester Utd",2018,"it ITA","DF",27,1989,4.9,16,14,7,7,2,6,19,31.6,13,5,3,2,7,23,23,0,"Matches","https://fbref.com/en/comps/9/2017-2018/defense/2017-2018-Premier-League-Stats"
"Ben Davies","Tottenham",2018,"wls WAL","DF",24,1993,25.8,47,33,13,21,13,25,48,52.1,23,24,5,19,28,75,70,1,"Matches","https://fbref.com/en/comps/9/2017-2018/defense/2017-2018-Premier-League-Stats"
"Tom Davies","Everton",2018,"eng ENG","MF",19,1998,21.1,30,20,14,11,5,12,54,22.2,42,19,5,14,24,54,21,0,"Matches","https://fbref.com/en/comps/9/2017-2018/defense/2017-2018-Premier-League-Stats"
"Steven Davis","Southampton",2018,"nir NIR","MF",32,1985,16.9,30,21,10,17,3,11,30,36.7,19,22,6,16,15,45,24,1,"Matches","https://fbref.com/en/comps/9/2017-2018/defense/2017-2018-Premier-League-Stats"
"Craig Dawson","West Brom",2018,"eng ENG","DF",27,1990,27.9,38,28,25,7,6,13,36,36.1,23,39,26,13,52,90,140,0,"Matches","https://fbref.com/en/comps/9/2017-2018/defense/2017-2018-Premier-League-Stats"
"Kevin De Bruyne","Manchester City",2018,"be BEL","MF",26,1991,34.1,62,43,23,25,14,23,80,28.8,57,45,2,43,25,87,14,2,"Matches","https://fbref.com/en/comps/9/2017-2018/defense/2017-2018-Premier-League-Stats"
"Troy Deeney","Watford",2018,"eng ENG","FW",29,1988,20.5,15,11,3,8,4,3,11,27.3,8,14,1,13,5,20,20,0,"Matches","https://fbref.com/en/comps/9/2017-2018/defense/2017-2018-Premier-League-Stats"
"Jermain Defoe","Bournemouth",2018,"eng ENG","FW",34,1982,12.1,12,9,2,6,4,2,10,20,8,10,0,10,4,16,1,0,"Matches","https://fbref.com/en/comps/9/2017-2018/defense/2017-2018-Premier-League-Stats"
"Steven Defour","Burnley",2018,"be BEL","MF",29,1988,22.2,33,22,12,18,3,10,46,21.7,36,35,7,28,46,79,25,0,"Matches","https://fbref.com/en/comps/9/2017-2018/defense/2017-2018-Premier-League-Stats"
"Damien Delaney","Crystal Palace",2018,"ie IRL","DF",36,1981,1.1,2,1,2,0,0,1,1,100,0,5,4,1,3,5,7,0,"Matches","https://fbref.com/en/comps/9/2017-2018/defense/2017-2018-Premier-League-Stats"
"Fabian Delph","Manchester City",2018,"eng ENG","DF",27,1989,19.3,46,34,21,16,9,18,37,48.6,19,16,0,16,30,76,42,2,"Matches","https://fbref.com/en/comps/9/2017-2018/defense/2017-2018-Premier-League-Stats"
"Mousa Dembélé","Tottenham",2018,"be BEL","MF",30,1987,20.9,36,24,19,11,6,9,37,24.3,28,20,0,20,33,69,15,0,"Matches","https://fbref.com/en/comps/9/2017-2018/defense/2017-2018-Premier-League-Stats"
"Laurent Depoitre","Huddersfield",2018,"be BEL","FW",28,1988,20.2,14,8,4,8,2,3,21,14.3,18,15,3,12,11,25,36,0,"Matches","https://fbref.com/en/comps/9/2017-2018/defense/2017-2018-Premier-League-Stats"
"Mike van der Hoorn","Swansea City",2018,"nl NED","DF",24,1992,21.6,32,22,23,8,1,16,24,66.7,8,24,14,10,39,71,127,0,"Matches","https://fbref.com/en/comps/9/2017-2018/defense/2017-2018-Premier-League-Stats"
"Gerard Deulofeu","Watford",2018,"es ESP","FW,MF",23,1994,4.8,5,3,2,2,1,2,11,18.2,9,0,0,0,4,9,3,1,"Matches","https://fbref.com/en/comps/9/2017-2018/defense/2017-2018-Premier-League-Stats"
"Fousseni Diabaté","Leicester City",2018,"ml MLI","MF,FW",21,1995,6.5,9,6,5,3,1,1,4,25,3,6,0,6,8,17,8,0,"Matches","https://fbref.com/en/comps/9/2017-2018/defense/2017-2018-Premier-League-Stats"
"Mohamed Diamé","Newcastle Utd",2018,"sn SEN","MF",30,1987,22.7,89,64,33,48,8,16,62,25.8,46,44,7,37,48,137,30,2,"Matches","https://fbref.com/en/comps/9/2017-2018/defense/2017-2018-Premier-League-Stats"
"Brahim Díaz","Manchester City",2018,"es ESP","FW,DF",17,1999,0.6,1,0,1,0,0,0,0,NA,0,3,0,3,1,2,0,0,"Matches","https://fbref.com/en/comps/9/2017-2018/defense/2017-2018-Premier-League-Stats"
"Eric Dier","Tottenham",2018,"eng ENG","MF,DF",23,1994,31.4,61,43,15,39,7,17,42,40.5,25,32,11,21,48,109,93,7,"Matches","https://fbref.com/en/comps/9/2017-2018/defense/2017-2018-Premier-League-Stats"
"Abdoulaye Doucouré","Watford",2018,"ml MLI","MF",24,1993,36.9,79,52,28,42,9,27,79,34.2,52,43,10,33,54,133,61,0,"Matches","https://fbref.com/en/comps/9/2017-2018/defense/2017-2018-Premier-League-Stats"
"Aleksandar Dragovic","Leicester City",2018,"at AUT","DF",26,1991,8.5,13,10,13,0,0,7,13,53.8,6,16,8,8,16,29,46,0,"Matches","https://fbref.com/en/comps/9/2017-2018/defense/2017-2018-Premier-League-Stats"
"Danny Drinkwater","Chelsea",2018,"eng ENG","MF",27,1990,5.9,15,10,6,8,1,3,17,17.6,14,10,2,8,8,23,7,0,"Matches","https://fbref.com/en/comps/9/2017-2018/defense/2017-2018-Premier-League-Stats"
"Martin Dúbravka","Newcastle Utd",2018,"sk SVK","GK",28,1989,12,0,0,0,0,0,0,0,NA,0,0,0,0,0,0,3,2,"Matches","https://fbref.com/en/comps/9/2017-2018/defense/2017-2018-Premier-League-Stats"
"Shane Duffy","Brighton",2018,"ie IRL","DF",25,1992,36.6,31,19,22,9,0,7,20,35,13,66,59,7,50,81,332,5,"Matches","https://fbref.com/en/comps/9/2017-2018/defense/2017-2018-Premier-League-Stats"
"Paul Dummett","Newcastle Utd",2018,"wls WAL","DF",25,1991,17.8,28,19,21,7,0,13,27,48.1,14,27,10,17,23,51,107,1,"Matches","https://fbref.com/en/comps/9/2017-2018/defense/2017-2018-Premier-League-Stats"
"Lewis Dunk","Brighton",2018,"eng ENG","DF",25,1991,38,67,33,49,18,0,25,48,52.1,23,73,58,15,71,138,230,2,"Matches","https://fbref.com/en/comps/9/2017-2018/defense/2017-2018-Premier-League-Stats"
"Nathan Dyer","Swansea City",2018,"eng ENG","MF,FW",29,1987,14.5,22,16,8,9,5,6,24,25,18,13,0,13,11,33,3,0,"Matches","https://fbref.com/en/comps/9/2017-2018/defense/2017-2018-Premier-League-Stats"
"Ederson","Manchester City",2018,"br BRA","GK",23,1993,35.5,1,1,1,0,0,0,0,NA,0,1,0,1,0,1,15,6,"Matches","https://fbref.com/en/comps/9/2017-2018/defense/2017-2018-Premier-League-Stats"
"Tom Edwards","Stoke City",2018,"eng ENG","DF,MF",18,1999,5.3,15,9,10,5,0,8,8,100,0,5,2,3,5,20,20,0,"Matches","https://fbref.com/en/comps/9/2017-2018/defense/2017-2018-Premier-League-Stats"
"Rob Elliot","Newcastle Utd",2018,"ie IRL","GK",31,1986,16,0,0,0,0,0,0,1,0,1,0,0,0,0,0,8,0,"Matches","https://fbref.com/en/comps/9/2017-2018/defense/2017-2018-Premier-League-Stats"
"Mohamed Elneny","Arsenal",2018,"eg EGY","MF",25,1992,9.6,12,6,6,3,3,6,10,60,4,11,0,11,10,22,12,2,"Matches","https://fbref.com/en/comps/9/2017-2018/defense/2017-2018-Premier-League-Stats"
"Christian Eriksen","Tottenham",2018,"dk DEN","MF,FW",25,1992,35.8,51,29,16,30,5,17,59,28.8,42,38,1,37,31,82,21,0,"Matches","https://fbref.com/en/comps/9/2017-2018/defense/2017-2018-Premier-League-Stats"
"Jonny Evans","West Brom",2018,"nir NIR","DF",29,1988,25.2,29,22,19,8,2,14,33,42.4,19,22,13,9,48,77,131,1,"Matches","https://fbref.com/en/comps/9/2017-2018/defense/2017-2018-Premier-League-Stats"
"Patrice Evra","West Ham",2018,"fr FRA","DF,MF",36,1981,2.5,6,4,5,1,0,6,8,75,2,4,1,3,7,13,6,0,"Matches","https://fbref.com/en/comps/9/2017-2018/defense/2017-2018-Premier-League-Stats"
"Lukasz Fabianski","Swansea City",2018,"pl POL","GK",32,1985,38,0,0,0,0,0,0,0,NA,0,0,0,0,0,0,10,2,"Matches","https://fbref.com/en/comps/9/2017-2018/defense/2017-2018-Premier-League-Stats"
"Cesc Fàbregas","Chelsea",2018,"es ESP","MF",30,1987,25.6,68,49,30,29,9,18,69,26.1,51,25,4,21,22,90,26,2,"Matches","https://fbref.com/en/comps/9/2017-2018/defense/2017-2018-Premier-League-Stats"
"Marouane Fellaini","Manchester Utd",2018,"be BEL","MF",29,1987,7.6,15,8,6,8,1,2,11,18.2,9,12,3,9,14,29,19,1,"Matches","https://fbref.com/en/comps/9/2017-2018/defense/2017-2018-Premier-League-Stats"
"Kiko Femenía","Watford",2018,"es ESP","DF,FW",26,1991,19,36,28,22,11,3,14,27,51.9,13,15,2,13,34,70,31,1,"Matches","https://fbref.com/en/comps/9/2017-2018/defense/2017-2018-Premier-League-Stats"
"Leroy Fer","Swansea City",2018,"nl NED","MF",27,1990,15.5,44,32,18,21,5,13,30,43.3,17,18,4,14,12,56,24,3,"Matches","https://fbref.com/en/comps/9/2017-2018/defense/2017-2018-Premier-League-Stats"
"Edimilson Fernandes","West Ham",2018,"ch SUI","MF,DF",21,1996,9.4,17,9,10,7,0,9,21,42.9,12,13,1,12,16,33,8,0,"Matches","https://fbref.com/en/comps/9/2017-2018/defense/2017-2018-Premier-League-Stats"
"Federico Fernández","Swansea City",2018,"ar ARG","DF",28,1989,29.7,40,29,30,6,4,20,30,66.7,10,35,27,8,38,78,201,1,"Matches","https://fbref.com/en/comps/9/2017-2018/defense/2017-2018-Premier-League-Stats"
"Fernandinho","Manchester City",2018,"br BRA","MF",32,1985,32,62,35,22,28,12,24,65,36.9,41,38,6,32,47,109,68,2,"Matches","https://fbref.com/en/comps/9/2017-2018/defense/2017-2018-Premier-League-Stats"
"Sam Field","West Brom",2018,"eng ENG","MF",19,1998,6,14,11,8,4,2,3,10,30,7,6,1,5,11,25,8,0,"Matches","https://fbref.com/en/comps/9/2017-2018/defense/2017-2018-Premier-League-Stats"
"Roberto Firmino","Liverpool",2018,"br BRA","FW",25,1991,30.7,65,50,9,36,20,8,58,13.8,50,40,2,38,18,83,10,0,"Matches","https://fbref.com/en/comps/9/2017-2018/defense/2017-2018-Premier-League-Stats"
"Darren Fletcher","Stoke City",2018,"sct SCO","MF",33,1984,24.7,47,26,23,20,4,15,55,27.3,40,13,3,10,26,73,33,3,"Matches","https://fbref.com/en/comps/9/2017-2018/defense/2017-2018-Premier-League-Stats"
"Phil Foden","Manchester City",2018,"eng ENG","MF,FW",17,2000,0.5,1,1,0,1,0,0,1,0,1,0,0,0,0,1,1,0,"Matches","https://fbref.com/en/comps/9/2017-2018/defense/2017-2018-Premier-League-Stats"
"José Fonte","West Ham",2018,"pt POR","DF",33,1983,7.6,11,6,5,6,0,2,6,33.3,4,12,9,3,14,25,37,1,"Matches","https://fbref.com/en/comps/9/2017-2018/defense/2017-2018-Premier-League-Stats"
"Fraser Forster","Southampton",2018,"eng ENG","GK",29,1988,20,0,0,0,0,0,0,0,NA,0,0,0,0,0,0,7,4,"Matches","https://fbref.com/en/comps/9/2017-2018/defense/2017-2018-Premier-League-Stats"
"Ben Foster","West Brom",2018,"eng ENG","GK",34,1983,37,1,0,1,0,0,0,7,0,7,0,0,0,1,2,12,1,"Matches","https://fbref.com/en/comps/9/2017-2018/defense/2017-2018-Premier-League-Stats"
"Timothy Fosu-Mensah","Crystal Palace",2018,"nl NED","DF",19,1998,17.7,42,33,33,8,1,21,34,61.8,13,17,9,8,31,73,74,1,"Matches","https://fbref.com/en/comps/9/2017-2018/defense/2017-2018-Premier-League-Stats"
"Simon Francis","Bournemouth",2018,"eng ENG","DF",32,1985,30.1,49,34,26,16,7,24,43,55.8,19,29,18,11,49,98,194,4,"Matches","https://fbref.com/en/comps/9/2017-2018/defense/2017-2018-Premier-League-Stats"
"Ryan Fraser","Bournemouth",2018,"sct SCO","MF,DF",23,1994,22.3,11,8,7,2,2,7,20,35,13,20,4,16,17,28,34,0,"Matches","https://fbref.com/en/comps/9/2017-2018/defense/2017-2018-Premier-League-Stats"
"Christian Fuchs","Leicester City",2018,"at AUT","DF",31,1986,21.3,41,27,25,12,4,14,40,35,26,23,3,20,58,99,86,0,"Matches","https://fbref.com/en/comps/9/2017-2018/defense/2017-2018-Premier-League-Stats"
"Jay Fulton","Swansea City",2018,"sct SCO","MF",23,1994,0.2,0,0,0,0,0,0,0,NA,0,0,0,0,0,0,1,0,"Matches","https://fbref.com/en/comps/9/2017-2018/defense/2017-2018-Premier-League-Stats"
"Ramiro Funes Mori","Everton",2018,"ar ARG","DF",26,1991,1.3,0,0,0,0,0,0,0,NA,0,1,1,0,3,3,14,0,"Matches","https://fbref.com/en/comps/9/2017-2018/defense/2017-2018-Premier-League-Stats"
"Manolo Gabbiadini","Southampton",2018,"it ITA","FW",25,1991,12,3,2,0,2,1,1,15,6.7,14,3,0,3,4,7,6,0,"Matches","https://fbref.com/en/comps/9/2017-2018/defense/2017-2018-Premier-League-Stats"
"Jesús Gámez","Newcastle Utd",2018,"es ESP","DF",32,1985,1.1,4,2,1,0,3,1,3,33.3,2,2,0,2,2,6,5,0,"Matches","https://fbref.com/en/comps/9/2017-2018/defense/2017-2018-Premier-League-Stats"
"Idrissa Gana Gueye","Everton",2018,"sn SEN","MF",27,1989,30.6,117,93,65,41,11,35,86,40.7,51,59,9,50,62,179,48,1,"Matches","https://fbref.com/en/comps/9/2017-2018/defense/2017-2018-Premier-League-Stats"
"Dwight Gayle","Newcastle Utd",2018,"eng ENG","FW",26,1990,21.8,12,10,2,8,2,1,21,4.8,20,16,2,14,6,18,17,0,"Matches","https://fbref.com/en/comps/9/2017-2018/defense/2017-2018-Premier-League-Stats"
"Paulo Gazzaniga","Tottenham",2018,"ar ARG","GK",25,1992,1,0,0,0,0,0,0,1,0,1,0,0,0,0,0,0,0,"Matches","https://fbref.com/en/comps/9/2017-2018/defense/2017-2018-Premier-League-Stats"
"David de Gea","Manchester Utd",2018,"es ESP","GK",26,1990,37,0,0,0,0,0,0,1,0,1,1,0,1,0,0,9,3,"Matches","https://fbref.com/en/comps/9/2017-2018/defense/2017-2018-Premier-League-Stats"
"Kieran Gibbs","West Brom",2018,"eng ENG","DF",27,1989,31.4,41,24,27,10,4,16,30,53.3,14,32,12,20,48,89,102,0,"Matches","https://fbref.com/en/comps/9/2017-2018/defense/2017-2018-Premier-League-Stats"
"Olivier Giroud","Arsenal",2018,"fr FRA","FW",30,1986,4.3,5,4,1,2,2,1,5,20,4,1,0,1,1,6,4,0,"Matches","https://fbref.com/en/comps/9/2017-2018/defense/2017-2018-Premier-League-Stats"
"Olivier Giroud","Chelsea",2018,"fr FRA","FW",30,1986,6.8,4,3,1,2,1,1,3,33.3,2,0,0,0,1,5,5,0,"Matches","https://fbref.com/en/comps/9/2017-2018/defense/2017-2018-Premier-League-Stats"
"Connor Goldson","Brighton",2018,"eng ENG","DF",24,1992,2.2,2,2,1,1,0,1,4,25,3,3,3,0,1,3,9,0,"Matches","https://fbref.com/en/comps/9/2017-2018/defense/2017-2018-Premier-League-Stats"
"Heurelho Gomes","Watford",2018,"br BRA","GK",36,1981,23.6,0,0,0,0,0,0,1,0,1,1,0,1,2,2,15,3,"Matches","https://fbref.com/en/comps/9/2017-2018/defense/2017-2018-Premier-League-Stats"
"Joe Gomez","Liverpool",2018,"eng ENG","DF",20,1997,21.1,58,45,32,23,3,21,40,52.5,19,19,8,11,34,92,57,1,"Matches","https://fbref.com/en/comps/9/2017-2018/defense/2017-2018-Premier-League-Stats"
"Dan Gosling","Bournemouth",2018,"eng ENG","MF",27,1990,21.6,50,25,19,26,5,19,68,27.9,49,36,8,28,25,75,35,0,"Matches","https://fbref.com/en/comps/9/2017-2018/defense/2017-2018-Premier-League-Stats"
"Lee Grant","Stoke City",2018,"eng ENG","GK",34,1983,3,1,1,1,0,0,1,1,100,0,0,0,0,0,1,0,0,"Matches","https://fbref.com/en/comps/9/2017-2018/defense/2017-2018-Premier-League-Stats"
"Andre Gray","Watford",2018,"jm JAM","FW",26,1991,16.6,2,1,0,1,1,0,3,0,3,11,0,11,4,6,3,0,"Matches","https://fbref.com/en/comps/9/2017-2018/defense/2017-2018-Premier-League-Stats"
"Demarai Gray","Leicester City",2018,"eng ENG","MF,FW",21,1996,18.9,17,15,6,9,2,4,23,17.4,19,27,0,27,11,28,14,1,"Matches","https://fbref.com/en/comps/9/2017-2018/defense/2017-2018-Premier-League-Stats"
"Pascal Groß","Brighton",2018,"de GER","FW,MF",26,1991,32.5,36,24,18,16,2,10,67,14.9,57,31,5,26,14,50,20,0,"Matches","https://fbref.com/en/comps/9/2017-2018/defense/2017-2018-Premier-League-Stats"
"Marko Grujic","Liverpool",2018,"rs SRB","MF,DF",21,1996,0.2,2,2,0,1,1,2,2,100,0,0,0,0,0,2,0,0,"Matches","https://fbref.com/en/comps/9/2017-2018/defense/2017-2018-Premier-League-Stats"
"Ilkay Gündogan","Manchester City",2018,"de GER","MF",26,1990,16.9,27,15,8,14,5,9,37,24.3,28,14,1,13,16,43,12,0,"Matches","https://fbref.com/en/comps/9/2017-2018/defense/2017-2018-Premier-League-Stats"
"Florent Hadergjonaj","Huddersfield",2018,"xk KVX","DF,MF",23,1994,18.6,21,16,7,10,4,12,30,40,18,22,10,12,17,38,45,0,"Matches","https://fbref.com/en/comps/9/2017-2018/defense/2017-2018-Premier-League-Stats"
"Massadio Haïdara","Newcastle Utd",2018,"ml MLI","FW",24,1992,0,0,0,0,0,0,0,0,NA,0,0,0,0,0,0,0,0,"Matches","https://fbref.com/en/comps/9/2017-2018/defense/2017-2018-Premier-League-Stats"
"Ben Hamer","Leicester City",2018,"eng ENG","GK",29,1987,3.1,0,0,0,0,0,0,1,0,1,0,0,0,0,0,3,1,"Matches","https://fbref.com/en/comps/9/2017-2018/defense/2017-2018-Premier-League-Stats"
"Rekeem Harper","West Brom",2018,"eng ENG","MF",17,2000,0.2,1,1,0,1,0,0,0,NA,0,0,0,0,0,1,0,0,"Matches","https://fbref.com/en/comps/9/2017-2018/defense/2017-2018-Premier-League-Stats"
"Joe Hart","West Ham",2018,"eng ENG","GK",30,1987,19,1,1,1,0,0,1,2,50,1,1,0,1,0,1,2,4,"Matches","https://fbref.com/en/comps/9/2017-2018/defense/2017-2018-Premier-League-Stats"
"Isaac Hayden","Newcastle Utd",2018,"eng ENG","MF",22,1995,15.3,40,23,23,16,1,12,34,35.3,22,21,6,15,23,63,43,0,"Matches","https://fbref.com/en/comps/9/2017-2018/defense/2017-2018-Premier-League-Stats"
"Eden Hazard","Chelsea",2018,"be BEL","FW,MF",26,1991,26.9,6,3,2,3,1,3,21,14.3,18,11,0,11,3,9,0,0,"Matches","https://fbref.com/en/comps/9/2017-2018/defense/2017-2018-Premier-League-Stats"
"Tom Heaton","Burnley",2018,"eng ENG","GK",31,1986,3.4,0,0,0,0,0,0,0,NA,0,0,0,0,0,0,0,0,"Matches","https://fbref.com/en/comps/9/2017-2018/defense/2017-2018-Premier-League-Stats"
"Michael Hefele","Huddersfield",2018,"de GER","DF",26,1990,0.4,0,0,0,0,0,0,0,NA,0,0,0,0,1,1,5,0,"Matches","https://fbref.com/en/comps/9/2017-2018/defense/2017-2018-Premier-League-Stats"
"Ahmed Hegazi","West Brom",2018,"eg EGY","DF",26,1991,37.6,58,38,46,12,0,26,50,52,24,55,37,18,60,118,278,2,"Matches","https://fbref.com/en/comps/9/2017-2018/defense/2017-2018-Premier-League-Stats"
"Tomer Hemed","Brighton",2018,"il ISR","FW",30,1987,9.4,7,5,3,4,0,2,10,20,8,10,1,9,2,9,12,0,"Matches","https://fbref.com/en/comps/9/2017-2018/defense/2017-2018-Premier-League-Stats"
"Jordan Henderson","Liverpool",2018,"eng ENG","MF",27,1990,24.1,51,33,13,32,6,18,52,34.6,34,33,2,31,31,82,27,0,"Matches","https://fbref.com/en/comps/9/2017-2018/defense/2017-2018-Premier-League-Stats"
"Jeff Hendrick","Burnley",2018,"ie IRL","FW,MF",25,1992,25.9,16,10,4,10,2,3,17,17.6,14,11,2,9,8,24,21,1,"Matches","https://fbref.com/en/comps/9/2017-2018/defense/2017-2018-Premier-League-Stats"
"Wayne Hennessey","Crystal Palace",2018,"wls WAL","GK",30,1987,27,0,0,0,0,0,0,0,NA,0,1,0,1,2,2,5,1,"Matches","https://fbref.com/en/comps/9/2017-2018/defense/2017-2018-Premier-League-Stats"
"Javier Hernández","West Ham",2018,"mx MEX","FW",29,1988,17.2,11,7,2,7,2,3,14,21.4,11,6,1,5,6,17,1,0,"Matches","https://fbref.com/en/comps/9/2017-2018/defense/2017-2018-Premier-League-Stats"
"Ander Herrera","Manchester Utd",2018,"es ESP","MF",27,1989,14.1,56,29,32,20,4,20,69,29,49,33,6,27,34,90,22,2,"Matches","https://fbref.com/en/comps/9/2017-2018/defense/2017-2018-Premier-League-Stats"
"Son Heung-min","Tottenham",2018,"kr KOR","FW",25,1992,25.7,17,10,2,12,3,2,28,7.1,26,18,0,18,10,27,12,0,"Matches","https://fbref.com/en/comps/9/2017-2018/defense/2017-2018-Premier-League-Stats"
"Wesley Hoedt","Southampton",2018,"nl NED","DF",23,1994,28,60,51,48,12,0,36,61,59,25,32,17,15,40,100,177,2,"Matches","https://fbref.com/en/comps/9/2017-2018/defense/2017-2018-Premier-League-Stats"
"Jonathan Hogg","Huddersfield",2018,"eng ENG","MF",28,1988,26.6,93,64,29,59,5,26,89,29.2,63,51,12,39,69,162,48,0,"Matches","https://fbref.com/en/comps/9/2017-2018/defense/2017-2018-Premier-League-Stats"
"Rob Holding","Arsenal",2018,"eng ENG","DF",21,1995,9.1,19,14,13,5,1,4,12,33.3,8,16,10,6,21,40,40,2,"Matches","https://fbref.com/en/comps/9/2017-2018/defense/2017-2018-Premier-League-Stats"
"José Holebas","Watford",2018,"gr GRE","DF",33,1984,26.5,51,31,34,14,3,18,44,40.9,26,24,8,16,29,80,95,2,"Matches","https://fbref.com/en/comps/9/2017-2018/defense/2017-2018-Premier-League-Stats"
"Mason Holgate","Everton",2018,"eng ENG","DF",20,1996,13.2,23,16,15,7,1,10,21,47.6,11,12,9,3,23,46,86,2,"Matches","https://fbref.com/en/comps/9/2017-2018/defense/2017-2018-Premier-League-Stats"
"Callum Hudson-Odoi","Chelsea",2018,"eng ENG","FW,DF",16,2000,0.3,0,0,0,0,0,0,0,NA,0,0,0,0,0,0,0,0,"Matches","https://fbref.com/en/comps/9/2017-2018/defense/2017-2018-Premier-League-Stats"
"Will Hughes","Watford",2018,"eng ENG","MF",22,1995,11,34,18,7,18,9,9,19,47.4,10,16,1,15,15,49,6,0,"Matches","https://fbref.com/en/comps/9/2017-2018/defense/2017-2018-Premier-League-Stats"
"Jordan Hugill","West Ham",2018,"eng ENG","FW",25,1992,0.3,0,0,0,0,0,0,1,0,1,0,0,0,0,0,0,0,"Matches","https://fbref.com/en/comps/9/2017-2018/defense/2017-2018-Premier-League-Stats"
"Uwe Hünemeier","Brighton",2018,"de GER","DF",31,1986,0.2,0,0,0,0,0,0,0,NA,0,0,0,0,0,0,4,0,"Matches","https://fbref.com/en/comps/9/2017-2018/defense/2017-2018-Premier-League-Stats"
"Emerson Hyndman","Bournemouth",2018,"us USA","MF",21,1996,0.6,0,0,0,0,0,0,1,0,1,2,0,2,1,1,1,0,"Matches","https://fbref.com/en/comps/9/2017-2018/defense/2017-2018-Premier-League-Stats"
"Pierre Højbjerg","Southampton",2018,"dk DEN","MF",21,1995,18.6,45,29,24,18,3,13,56,23.2,43,30,3,27,37,82,26,1,"Matches","https://fbref.com/en/comps/9/2017-2018/defense/2017-2018-Premier-League-Stats"
"Jordon Ibe","Bournemouth",2018,"eng ENG","MF,FW",21,1995,22.2,14,12,7,5,2,6,22,27.3,16,5,0,5,10,24,11,0,"Matches","https://fbref.com/en/comps/9/2017-2018/defense/2017-2018-Premier-League-Stats"
"Vicente Iborra","Leicester City",2018,"es ESP","MF",29,1988,15.7,23,18,13,10,0,9,36,25,27,25,11,14,19,42,49,1,"Matches","https://fbref.com/en/comps/9/2017-2018/defense/2017-2018-Premier-League-Stats"
"Zlatan Ibrahimovic","Manchester Utd",2018,"se SWE","MF,FW",35,1981,1.2,2,1,1,0,1,0,1,0,1,0,0,0,0,2,1,0,"Matches","https://fbref.com/en/comps/9/2017-2018/defense/2017-2018-Premier-League-Stats"
"Kelechi Iheanacho","Leicester City",2018,"ng NGA","FW,MF",20,1996,9.2,9,6,3,5,1,3,20,15,17,10,2,8,3,12,4,0,"Matches","https://fbref.com/en/comps/9/2017-2018/defense/2017-2018-Premier-League-Stats"
"Tom Ince","Huddersfield",2018,"eng ENG","MF,FW",25,1992,27.2,35,27,14,16,5,10,29,34.5,19,20,0,20,12,47,12,0,"Matches","https://fbref.com/en/comps/9/2017-2018/defense/2017-2018-Premier-League-Stats"
"Danny Ings","Liverpool",2018,"eng ENG","FW",25,1992,3,5,3,1,3,1,0,0,NA,0,4,0,4,2,7,1,0,"Matches","https://fbref.com/en/comps/9/2017-2018/defense/2017-2018-Premier-League-Stats"
"Stephen Ireland","Stoke City",2018,"ie IRL","MF,FW",30,1986,1.5,3,1,2,1,0,1,5,20,4,4,2,2,1,4,1,0,"Matches","https://fbref.com/en/comps/9/2017-2018/defense/2017-2018-Premier-League-Stats"
"Alex Iwobi","Arsenal",2018,"ng NGA","MF,FW",21,1996,20.3,19,15,8,8,3,5,18,27.8,13,19,1,18,7,26,10,1,"Matches","https://fbref.com/en/comps/9/2017-2018/defense/2017-2018-Premier-League-Stats"
"José Izquierdo","Brighton",2018,"co COL","MF,FW",25,1992,22,23,15,12,9,2,7,19,36.8,12,6,0,6,16,39,34,0,"Matches","https://fbref.com/en/comps/9/2017-2018/defense/2017-2018-Premier-League-Stats"
"Phil Jagielka","Everton",2018,"eng ENG","DF",34,1982,22.9,33,23,24,9,0,8,21,38.1,13,30,20,10,39,72,179,1,"Matches","https://fbref.com/en/comps/9/2017-2018/defense/2017-2018-Premier-League-Stats"
"Eldin Jakupovic","Leicester City",2018,"ch SUI","GK",32,1984,2,0,0,0,0,0,0,0,NA,0,0,0,0,0,0,4,0,"Matches","https://fbref.com/en/comps/9/2017-2018/defense/2017-2018-Premier-League-Stats"
"Matty James","Leicester City",2018,"eng ENG","MF",26,1991,11,19,10,7,11,1,2,10,20,8,14,2,12,17,36,25,0,"Matches","https://fbref.com/en/comps/9/2017-2018/defense/2017-2018-Premier-League-Stats"
"Daryl Janmaat","Watford",2018,"nl NED","DF",28,1989,20.2,46,31,29,10,7,22,52,42.3,30,16,5,11,33,79,61,0,"Matches","https://fbref.com/en/comps/9/2017-2018/defense/2017-2018-Premier-League-Stats"
"Vincent Janssen","Tottenham",2018,"nl NED","DF",23,1994,0,0,0,0,0,0,0,0,NA,0,0,0,0,0,0,0,0,"Matches","https://fbref.com/en/comps/9/2017-2018/defense/2017-2018-Premier-League-Stats"
"Jesé","Stoke City",2018,"es ESP","FW,MF",24,1993,6.8,10,7,3,5,2,3,13,23.1,10,5,0,5,0,10,3,0,"Matches","https://fbref.com/en/comps/9/2017-2018/defense/2017-2018-Premier-League-Stats"
"Gabriel Jesus","Manchester City",2018,"br BRA","FW",20,1997,18.5,23,15,6,10,7,3,22,13.6,19,16,0,16,8,31,6,0,"Matches","https://fbref.com/en/comps/9/2017-2018/defense/2017-2018-Premier-League-Stats"
"Glen Johnson","Stoke City",2018,"eng ENG","DF",32,1984,6.1,7,5,5,2,0,3,12,25,9,7,2,5,10,17,23,0,"Matches","https://fbref.com/en/comps/9/2017-2018/defense/2017-2018-Premier-League-Stats"
"Phil Jones","Manchester Utd",2018,"eng ENG","DF",25,1992,21.9,25,18,20,5,0,9,20,45,11,25,17,8,41,66,133,2,"Matches","https://fbref.com/en/comps/9/2017-2018/defense/2017-2018-Premier-League-Stats"
"Joselu","Newcastle Utd",2018,"es ESP","FW",27,1990,19,22,17,10,11,1,7,34,20.6,27,25,2,23,11,33,39,0,"Matches","https://fbref.com/en/comps/9/2017-2018/defense/2017-2018-Premier-League-Stats"
"Mathias Jørgensen","Huddersfield",2018,"dk DEN","DF",27,1990,38,55,36,40,13,2,19,45,42.2,26,49,20,29,76,131,249,5,"Matches","https://fbref.com/en/comps/9/2017-2018/defense/2017-2018-Premier-League-Stats"
"Christian Kabasele","Watford",2018,"be BEL","DF",26,1991,25.9,42,25,28,14,0,21,36,58.3,15,37,23,14,34,76,185,0,"Matches","https://fbref.com/en/comps/9/2017-2018/defense/2017-2018-Premier-League-Stats"
"Younès Kaboul","Watford",2018,"fr FRA","DF",31,1986,1.7,3,2,0,3,0,0,0,NA,0,4,2,2,2,5,15,0,"Matches","https://fbref.com/en/comps/9/2017-2018/defense/2017-2018-Premier-League-Stats"
"Elias Kachunga","Huddersfield",2018,"cd COD","FW,MF",25,1992,14.8,30,26,13,12,5,8,19,42.1,11,14,1,13,2,32,9,0,"Matches","https://fbref.com/en/comps/9/2017-2018/defense/2017-2018-Premier-League-Stats"
"Sullay Kaikai","Crystal Palace",2018,"sl SLE","MF",21,1995,0.2,1,0,0,1,0,0,0,NA,0,1,0,1,0,1,1,0,"Matches","https://fbref.com/en/comps/9/2017-2018/defense/2017-2018-Premier-League-Stats"
"Harry Kane","Tottenham",2018,"eng ENG","FW",24,1993,34.2,17,12,2,8,7,4,15,26.7,11,15,4,11,5,22,19,0,"Matches","https://fbref.com/en/comps/9/2017-2018/defense/2017-2018-Premier-League-Stats"
"N'Golo Kanté","Chelsea",2018,"fr FRA","MF",26,1991,33.3,113,77,55,52,6,33,92,35.9,59,40,4,36,85,198,29,3,"Matches","https://fbref.com/en/comps/9/2017-2018/defense/2017-2018-Premier-League-Stats"
"Loris Karius","Liverpool",2018,"de GER","GK",24,1993,19,0,0,0,0,0,0,0,NA,0,0,0,0,1,1,4,0,"Matches","https://fbref.com/en/comps/9/2017-2018/defense/2017-2018-Premier-League-Stats"
"Orestis Karnezis","Watford",2018,"gr GRE","GK",32,1985,14.4,0,0,0,0,0,0,2,0,2,0,0,0,1,1,3,3,"Matches","https://fbref.com/en/comps/9/2017-2018/defense/2017-2018-Premier-League-Stats"
"Beram Kayal","Brighton",2018,"il ISR","MF",29,1988,8.3,18,11,10,7,1,6,26,23.1,20,11,4,7,12,30,9,0,"Matches","https://fbref.com/en/comps/9/2017-2018/defense/2017-2018-Premier-League-Stats"
"Michael Keane","Everton",2018,"eng ENG","DF",24,1993,28.4,33,25,26,5,2,19,43,44.2,24,39,28,11,53,86,214,0,"Matches","https://fbref.com/en/comps/9/2017-2018/defense/2017-2018-Premier-League-Stats"
"Martin Kelly","Crystal Palace",2018,"eng ENG","DF",27,1990,13.3,19,13,15,4,0,14,26,53.8,12,16,11,5,9,28,67,3,"Matches","https://fbref.com/en/comps/9/2017-2018/defense/2017-2018-Premier-League-Stats"
"Kenedy","Newcastle Utd",2018,"br BRA","MF,DF",21,1996,11.4,31,17,16,13,2,12,35,34.3,23,12,1,11,14,45,11,0,"Matches","https://fbref.com/en/comps/9/2017-2018/defense/2017-2018-Premier-League-Stats"
"Jonjoe Kenny","Everton",2018,"eng ENG","DF",20,1997,17.7,41,33,28,10,3,20,32,62.5,12,17,7,10,28,69,95,0,"Matches","https://fbref.com/en/comps/9/2017-2018/defense/2017-2018-Premier-League-Stats"
"Andy King","Leicester City",2018,"wls WAL","MF",28,1988,6,8,5,0,5,3,0,3,0,3,4,2,2,5,13,13,0,"Matches","https://fbref.com/en/comps/9/2017-2018/defense/2017-2018-Premier-League-Stats"
"Andy King","Swansea City",2018,"wls WAL","MF",28,1988,7.9,18,11,10,8,0,5,14,35.7,9,7,0,7,6,24,14,1,"Matches","https://fbref.com/en/comps/9/2017-2018/defense/2017-2018-Premier-League-Stats"
"Joshua King","Bournemouth",2018,"no NOR","FW,MF",25,1992,27.3,36,26,11,17,8,4,27,14.8,23,23,3,20,4,40,14,1,"Matches","https://fbref.com/en/comps/9/2017-2018/defense/2017-2018-Premier-League-Stats"
"Davy Klaassen","Everton",2018,"nl NED","MF,FW",24,1993,2.8,3,1,1,2,0,2,6,33.3,4,2,1,1,1,4,2,0,"Matches","https://fbref.com/en/comps/9/2017-2018/defense/2017-2018-Premier-League-Stats"
"Ragnar Klavan","Liverpool",2018,"ee EST","DF",31,1985,16.1,14,10,6,7,1,6,12,50,6,11,5,6,15,29,85,1,"Matches","https://fbref.com/en/comps/9/2017-2018/defense/2017-2018-Premier-League-Stats"
"Anthony Knockaert","Brighton",2018,"fr FRA","MF,FW",25,1991,26.9,39,26,25,11,3,16,55,29.1,39,29,3,26,23,62,16,0,"Matches","https://fbref.com/en/comps/9/2017-2018/defense/2017-2018-Premier-League-Stats"
"Sead Kolainac","Arsenal",2018,"ba BIH","DF",24,1993,23.9,49,37,28,13,8,20,39,51.3,19,15,3,12,26,75,56,0,"Matches","https://fbref.com/en/comps/9/2017-2018/defense/2017-2018-Premier-League-Stats"
"Vincent Kompany","Manchester City",2018,"be BEL","DF",31,1986,15.5,20,11,14,5,1,13,19,68.4,6,10,8,2,16,36,73,1,"Matches","https://fbref.com/en/comps/9/2017-2018/defense/2017-2018-Premier-League-Stats"
"Terence Kongolo","Huddersfield",2018,"nl NED","DF",23,1994,11.7,33,20,19,13,1,14,22,63.6,8,12,6,6,32,65,71,0,"Matches","https://fbref.com/en/comps/9/2017-2018/defense/2017-2018-Premier-League-Stats"
"Laurent Koscielny","Arsenal",2018,"fr FRA","DF",31,1985,24.7,43,21,27,12,4,19,33,57.6,14,28,15,13,54,97,138,3,"Matches","https://fbref.com/en/comps/9/2017-2018/defense/2017-2018-Premier-League-Stats"
"Cheikhou Kouyaté","West Ham",2018,"sn SEN","MF",27,1989,31.1,71,49,43,26,2,23,62,37.1,39,31,11,20,32,103,56,1,"Matches","https://fbref.com/en/comps/9/2017-2018/defense/2017-2018-Premier-League-Stats"
"Bojan Krkic","Stoke City",2018,"es ESP","MF",26,1990,0.8,0,0,0,0,0,0,1,0,1,1,0,1,0,0,0,0,"Matches","https://fbref.com/en/comps/9/2017-2018/defense/2017-2018-Premier-League-Stats"
"Grzegorz Krychowiak","West Brom",2018,"pl POL","MF",27,1990,18.2,39,24,18,17,4,12,49,24.5,37,23,5,18,45,84,23,0,"Matches","https://fbref.com/en/comps/9/2017-2018/defense/2017-2018-Premier-League-Stats"
"Rajiv van La Parra","Huddersfield",2018,"nl NED","FW,MF",26,1991,23.7,41,29,18,15,8,12,41,29.3,29,27,1,26,21,62,8,1,"Matches","https://fbref.com/en/comps/9/2017-2018/defense/2017-2018-Premier-League-Stats"
"Alexandre Lacazette","Arsenal",2018,"fr FRA","FW",26,1991,24.5,24,17,6,11,7,4,27,14.8,23,19,3,16,7,31,5,0,"Matches","https://fbref.com/en/comps/9/2017-2018/defense/2017-2018-Premier-League-Stats"
"Freddie Ladapo","Crystal Palace",2018,"eng ENG","FW",24,1993,0.2,0,0,0,0,0,0,0,NA,0,0,0,0,0,0,0,0,"Matches","https://fbref.com/en/comps/9/2017-2018/defense/2017-2018-Premier-League-Stats"
"Adam Lallana","Liverpool",2018,"eng ENG","MF,FW",29,1988,3.4,3,1,3,0,0,2,10,20,8,3,0,3,1,4,1,0,"Matches","https://fbref.com/en/comps/9/2017-2018/defense/2017-2018-Premier-League-Stats"
"Érik Lamela","Tottenham",2018,"ar ARG","FW,MF",25,1992,9.4,23,13,9,7,7,3,20,15,17,11,1,10,7,30,5,0,"Matches","https://fbref.com/en/comps/9/2017-2018/defense/2017-2018-Premier-League-Stats"
"Manuel Lanzini","West Ham",2018,"ar ARG","MF,FW",24,1993,22.7,20,11,6,11,3,2,34,5.9,32,7,1,6,30,50,5,2,"Matches","https://fbref.com/en/comps/9/2017-2018/defense/2017-2018-Premier-League-Stats"
"Aymeric Laporte","Manchester City",2018,"es ESP","DF",23,1994,9,8,7,6,2,0,3,8,37.5,5,2,1,1,11,19,27,0,"Matches","https://fbref.com/en/comps/9/2017-2018/defense/2017-2018-Premier-League-Stats"
"Jamaal Lascelles","Newcastle Utd",2018,"eng ENG","DF",23,1993,32.5,31,19,19,11,1,12,19,63.2,7,33,24,9,28,59,232,1,"Matches","https://fbref.com/en/comps/9/2017-2018/defense/2017-2018-Premier-League-Stats"
"Florian Lejeune","Newcastle Utd",2018,"fr FRA","DF",26,1991,23.4,34,20,26,8,0,14,30,46.7,16,21,15,6,46,80,154,0,"Matches","https://fbref.com/en/comps/9/2017-2018/defense/2017-2018-Premier-League-Stats"
"Mario Lemina","Southampton",2018,"ga GAB","MF",23,1993,19.1,55,40,21,29,5,12,30,40,18,18,6,12,36,91,36,4,"Matches","https://fbref.com/en/comps/9/2017-2018/defense/2017-2018-Premier-League-Stats"
"Aaron Lennon","Burnley",2018,"eng ENG","MF",30,1987,12.4,20,14,5,14,1,2,20,10,18,20,5,15,8,28,18,0,"Matches","https://fbref.com/en/comps/9/2017-2018/defense/2017-2018-Premier-League-Stats"
"Aaron Lennon","Everton",2018,"eng ENG","FW,MF",30,1987,8.8,17,10,10,5,2,5,21,23.8,16,13,1,12,11,28,9,0,"Matches","https://fbref.com/en/comps/9/2017-2018/defense/2017-2018-Premier-League-Stats"
"Victor Lindelöf","Manchester Utd",2018,"se SWE","DF",23,1994,14.3,17,11,10,6,1,9,14,64.3,5,15,11,4,13,30,67,1,"Matches","https://fbref.com/en/comps/9/2017-2018/defense/2017-2018-Premier-League-Stats"
"Jesse Lingard","Manchester Utd",2018,"eng ENG","MF,FW",24,1992,20.2,30,21,10,13,7,5,27,18.5,22,18,3,15,9,39,13,0,"Matches","https://fbref.com/en/comps/9/2017-2018/defense/2017-2018-Premier-League-Stats"
"Jake Livermore","West Brom",2018,"eng ENG","MF",27,1989,29.7,72,41,27,35,10,24,64,37.5,40,44,9,35,26,98,36,2,"Matches","https://fbref.com/en/comps/9/2017-2018/defense/2017-2018-Premier-League-Stats"
"Fernando Llorente","Tottenham",2018,"es ESP","FW,MF",32,1985,2.6,6,3,1,2,3,1,2,50,1,0,0,0,0,6,6,0,"Matches","https://fbref.com/en/comps/9/2017-2018/defense/2017-2018-Premier-League-Stats"
"Hugo Lloris","Tottenham",2018,"fr FRA","GK",30,1986,36,1,1,1,0,0,1,4,25,3,0,0,0,2,3,34,8,"Matches","https://fbref.com/en/comps/9/2017-2018/defense/2017-2018-Premier-League-Stats"
"Jürgen Locadia","Brighton",2018,"nl NED","FW,MF",23,1993,2.5,1,0,0,1,0,0,1,0,1,0,0,0,1,2,1,1,"Matches","https://fbref.com/en/comps/9/2017-2018/defense/2017-2018-Premier-League-Stats"
"Ruben Loftus-Cheek","Crystal Palace",2018,"eng ENG","MF",21,1996,20.8,21,15,7,13,1,7,30,23.3,23,19,2,17,22,43,31,0,"Matches","https://fbref.com/en/comps/9/2017-2018/defense/2017-2018-Premier-League-Stats"
"Joe Lolley","Huddersfield",2018,"eng ENG","FW,MF",24,1992,2.5,2,0,1,1,0,0,2,0,2,0,0,0,3,5,2,1,"Matches","https://fbref.com/en/comps/9/2017-2018/defense/2017-2018-Premier-League-Stats"
"Kevin Long","Burnley",2018,"ie IRL","DF",26,1990,16,32,23,28,4,0,16,26,61.5,10,25,14,11,19,51,129,1,"Matches","https://fbref.com/en/comps/9/2017-2018/defense/2017-2018-Premier-League-Stats"
"Shane Long","Southampton",2018,"ie IRL","FW",30,1987,17.6,25,20,1,19,5,10,30,33.3,20,14,2,12,12,37,29,0,"Matches","https://fbref.com/en/comps/9/2017-2018/defense/2017-2018-Premier-League-Stats"
"Ademola Lookman","Everton",2018,"ng NGA","FW,MF",19,1997,1.8,1,1,0,1,0,0,2,0,2,2,0,2,1,2,3,0,"Matches","https://fbref.com/en/comps/9/2017-2018/defense/2017-2018-Premier-League-Stats"
"Jonas Lössl","Huddersfield",2018,"dk DEN","GK",28,1989,38,1,0,1,0,0,1,5,20,4,0,0,0,4,5,13,6,"Matches","https://fbref.com/en/comps/9/2017-2018/defense/2017-2018-Premier-League-Stats"
"Dejan Lovren","Liverpool",2018,"hr CRO","DF",28,1989,23.6,26,17,14,11,1,12,22,54.5,10,26,15,11,38,64,146,2,"Matches","https://fbref.com/en/comps/9/2017-2018/defense/2017-2018-Premier-League-Stats"
"Chris Löwe","Huddersfield",2018,"de GER","DF",28,1989,17.6,43,29,26,15,2,20,44,45.5,24,21,8,13,34,77,65,3,"Matches","https://fbref.com/en/comps/9/2017-2018/defense/2017-2018-Premier-League-Stats"
"Matthew Lowton","Burnley",2018,"eng ENG","DF",28,1989,25.5,55,34,26,27,2,28,60,46.7,32,35,15,20,39,94,141,2,"Matches","https://fbref.com/en/comps/9/2017-2018/defense/2017-2018-Premier-League-Stats"
"David Luiz","Chelsea",2018,"br BRA","DF,MF",30,1987,9.3,18,11,13,4,1,11,21,52.4,10,9,5,4,24,42,45,2,"Matches","https://fbref.com/en/comps/9/2017-2018/defense/2017-2018-Premier-League-Stats"
"Romelu Lukaku","Manchester Utd",2018,"be BEL","FW",24,1993,31.9,7,4,1,3,3,0,13,0,13,9,2,7,3,10,22,2,"Matches","https://fbref.com/en/comps/9/2017-2018/defense/2017-2018-Premier-League-Stats"
"Dodi Lukebakio","Watford",2018,"be BEL","MF,FW",19,1997,0.2,1,0,1,0,0,0,0,NA,0,0,0,0,0,1,0,0,"Matches","https://fbref.com/en/comps/9/2017-2018/defense/2017-2018-Premier-League-Stats"
"Levi Lumeka","Crystal Palace",2018,"eng ENG","FW",18,1998,0.3,1,1,1,0,0,0,0,NA,0,0,0,0,1,2,0,0,"Matches","https://fbref.com/en/comps/9/2017-2018/defense/2017-2018-Premier-League-Stats"
"Harry Maguire","Leicester City",2018,"eng ENG","DF",24,1993,38,63,46,47,15,1,26,43,60.5,17,35,28,7,48,111,181,1,"Matches","https://fbref.com/en/comps/9/2017-2018/defense/2017-2018-Premier-League-Stats"
"Riyad Mahrez","Leicester City",2018,"dz ALG","MF,FW",26,1991,32.8,39,27,16,17,6,10,63,15.9,53,32,1,31,18,57,15,0,"Matches","https://fbref.com/en/comps/9/2017-2018/defense/2017-2018-Premier-League-Stats"
"Ainsley Maitland-Niles","Arsenal",2018,"eng ENG","DF,MF",19,1997,10.2,25,17,12,7,6,14,31,45.2,17,15,1,14,12,37,35,2,"Matches","https://fbref.com/en/comps/9/2017-2018/defense/2017-2018-Premier-League-Stats"
"Scott Malone","Huddersfield",2018,"eng ENG","DF",26,1991,12.4,39,29,27,10,2,17,24,70.8,7,12,2,10,26,65,43,2,"Matches","https://fbref.com/en/comps/9/2017-2018/defense/2017-2018-Premier-League-Stats"
"Sadio Mané","Liverpool",2018,"sn SEN","FW",25,1992,24.3,28,20,8,11,9,3,23,13,20,20,0,20,9,37,8,0,"Matches","https://fbref.com/en/comps/9/2017-2018/defense/2017-2018-Premier-League-Stats"
"Eliaquim Mangala","Everton",2018,"fr FRA","DF",26,1991,1.5,2,1,1,1,0,0,0,NA,0,0,0,0,1,3,4,1,"Matches","https://fbref.com/en/comps/9/2017-2018/defense/2017-2018-Premier-League-Stats"
"Eliaquim Mangala","Manchester City",2018,"fr FRA","DF",26,1991,5.4,5,3,5,0,0,1,3,33.3,2,4,3,1,2,7,24,0,"Matches","https://fbref.com/en/comps/9/2017-2018/defense/2017-2018-Premier-League-Stats"
"Javier Manquillo","Newcastle Utd",2018,"es ESP","DF",23,1994,19.5,36,22,25,8,3,15,30,50,15,25,6,19,18,54,65,0,"Matches","https://fbref.com/en/comps/9/2017-2018/defense/2017-2018-Premier-League-Stats"
"Solly March","Brighton",2018,"eng ENG","MF,FW",23,1994,20.6,54,41,34,14,6,22,54,40.7,32,27,3,24,13,67,49,0,"Matches","https://fbref.com/en/comps/9/2017-2018/defense/2017-2018-Premier-League-Stats"
"Adrian Mariappa","Watford",2018,"jm JAM","DF",30,1986,24.6,45,26,33,12,0,14,34,41.2,20,25,16,9,45,90,133,4,"Matches","https://fbref.com/en/comps/9/2017-2018/defense/2017-2018-Premier-League-Stats"
"João Mário","West Ham",2018,"pt POR","MF",24,1993,11.4,14,11,6,5,3,6,19,31.6,13,7,0,7,8,22,4,1,"Matches","https://fbref.com/en/comps/9/2017-2018/defense/2017-2018-Premier-League-Stats"
"Anthony Martial","Manchester Utd",2018,"fr FRA","FW",21,1995,17.6,15,13,9,2,4,3,12,25,9,5,1,4,3,18,7,0,"Matches","https://fbref.com/en/comps/9/2017-2018/defense/2017-2018-Premier-League-Stats"
"Cuco Martina","Everton",2018,"cw CUW","DF",27,1989,20.3,61,35,38,15,8,27,46,58.7,19,17,4,13,42,103,130,2,"Matches","https://fbref.com/en/comps/9/2017-2018/defense/2017-2018-Premier-League-Stats"
"Bruno Martins Indi","Stoke City",2018,"nl NED","DF",25,1992,13.8,21,12,18,3,0,10,19,52.6,9,16,11,5,21,42,77,1,"Matches","https://fbref.com/en/comps/9/2017-2018/defense/2017-2018-Premier-League-Stats"
"Arthur Masuaku","West Ham",2018,"cd COD","DF",23,1993,20.8,58,37,36,16,6,25,58,43.1,33,25,2,23,26,84,38,1,"Matches","https://fbref.com/en/comps/9/2017-2018/defense/2017-2018-Premier-League-Stats"
"Juan Mata","Manchester Utd",2018,"es ESP","FW",29,1988,21.4,18,13,4,12,2,2,24,8.3,22,10,0,10,15,33,10,1,"Matches","https://fbref.com/en/comps/9/2017-2018/defense/2017-2018-Premier-League-Stats"
"Nemanja Matic","Manchester Utd",2018,"rs SRB","MF",28,1988,34.6,70,42,32,34,4,23,71,32.4,48,50,13,37,64,134,62,2,"Matches","https://fbref.com/en/comps/9/2017-2018/defense/2017-2018-Premier-League-Stats"
"Joël Matip","Liverpool",2018,"cm CMR","DF",25,1991,22.2,35,24,23,11,1,12,24,50,12,26,15,11,35,70,101,1,"Matches","https://fbref.com/en/comps/9/2017-2018/defense/2017-2018-Premier-League-Stats"
"Konstantinos Mavropanos","Arsenal",2018,"gr GRE","DF",19,1997,2.2,1,1,1,0,0,1,2,50,1,4,3,1,6,7,11,1,"Matches","https://fbref.com/en/comps/9/2017-2018/defense/2017-2018-Premier-League-Stats"
"Alfie Mawson","Swansea City",2018,"eng ENG","DF",23,1994,38,32,22,24,8,0,16,27,59.3,11,41,32,9,35,67,229,5,"Matches","https://fbref.com/en/comps/9/2017-2018/defense/2017-2018-Premier-League-Stats"
"Eric Maxim Choupo-Moting","Stoke City",2018,"cm CMR","FW,MF",28,1989,25.7,42,30,21,16,5,9,32,28.1,23,31,3,28,23,65,29,1,"Matches","https://fbref.com/en/comps/9/2017-2018/defense/2017-2018-Premier-League-Stats"
"Chancel Mbemba","Newcastle Utd",2018,"cd COD","DF",22,1994,7.5,16,12,13,3,0,10,17,58.8,7,7,3,4,15,31,44,1,"Matches","https://fbref.com/en/comps/9/2017-2018/defense/2017-2018-Premier-League-Stats"
"James McArthur","Crystal Palace",2018,"sct SCO","MF",29,1987,27,58,44,28,27,3,23,61,37.7,38,39,2,37,36,94,44,2,"Matches","https://fbref.com/en/comps/9/2017-2018/defense/2017-2018-Premier-League-Stats"
"Gareth McAuley","West Brom",2018,"nir NIR","DF",37,1979,5.1,8,7,6,2,0,3,7,42.9,4,7,4,3,11,19,16,0,"Matches","https://fbref.com/en/comps/9/2017-2018/defense/2017-2018-Premier-League-Stats"
"Oliver McBurnie","Swansea City",2018,"sct SCO","FW,MF",21,1996,3.1,4,3,0,2,2,1,3,33.3,2,2,0,2,0,4,3,0,"Matches","https://fbref.com/en/comps/9/2017-2018/defense/2017-2018-Premier-League-Stats"
"Alex McCarthy","Southampton",2018,"eng ENG","GK",27,1989,18,0,0,0,0,0,0,0,NA,0,0,0,0,1,1,8,0,"Matches","https://fbref.com/en/comps/9/2017-2018/defense/2017-2018-Premier-League-Stats"
"James McCarthy","Everton",2018,"ie IRL","MF",26,1990,2.3,9,9,3,4,2,1,5,20,4,9,2,7,5,14,3,1,"Matches","https://fbref.com/en/comps/9/2017-2018/defense/2017-2018-Premier-League-Stats"
"James McClean","West Brom",2018,"ie IRL","MF,FW",28,1989,15.6,40,28,23,14,3,10,55,18.2,45,18,4,14,20,60,22,0,"Matches","https://fbref.com/en/comps/9/2017-2018/defense/2017-2018-Premier-League-Stats"
"Sam McQueen","Southampton",2018,"eng ENG","DF,MF",22,1995,1.6,4,4,4,0,0,2,4,50,2,2,1,1,3,7,3,0,"Matches","https://fbref.com/en/comps/9/2017-2018/defense/2017-2018-Premier-League-Stats"
"Scott McTominay","Manchester Utd",2018,"sct SCO","MF",20,1996,7,11,9,4,5,2,5,13,38.5,8,3,0,3,13,24,9,0,"Matches","https://fbref.com/en/comps/9/2017-2018/defense/2017-2018-Premier-League-Stats"
"Ben Mee","Burnley",2018,"eng ENG","DF",27,1989,29,33,20,22,11,0,16,29,55.2,13,51,42,9,33,66,217,1,"Matches","https://fbref.com/en/comps/9/2017-2018/defense/2017-2018-Premier-League-Stats"
"Benjamin Mendy","Manchester City",2018,"fr FRA","DF,FW",23,1994,4,5,4,2,0,3,5,7,71.4,2,5,0,5,8,13,9,0,"Matches","https://fbref.com/en/comps/9/2017-2018/defense/2017-2018-Premier-League-Stats"
"Mikel Merino","Newcastle Utd",2018,"es ESP","MF",21,1996,15,56,40,21,32,3,17,56,30.4,39,36,8,28,34,90,25,0,"Matches","https://fbref.com/en/comps/9/2017-2018/defense/2017-2018-Premier-League-Stats"
"Per Mertesacker","Arsenal",2018,"de GER","DF",32,1984,4.1,2,2,0,2,0,0,1,0,1,4,3,1,6,8,22,2,"Matches","https://fbref.com/en/comps/9/2017-2018/defense/2017-2018-Premier-League-Stats"
"Roque Mesa","Swansea City",2018,"es ESP","MF",28,1989,8.4,20,13,8,8,4,10,37,27,27,6,0,6,13,33,8,1,"Matches","https://fbref.com/en/comps/9/2017-2018/defense/2017-2018-Premier-League-Stats"
"Simon Mignolet","Liverpool",2018,"be BEL","GK",29,1988,19,2,1,2,0,0,1,3,33.3,2,0,0,0,0,2,5,3,"Matches","https://fbref.com/en/comps/9/2017-2018/defense/2017-2018-Premier-League-Stats"
"Luka Milivojevic","Crystal Palace",2018,"rs SRB","MF",26,1991,34.2,85,52,40,37,8,31,86,36,55,50,12,38,71,156,81,3,"Matches","https://fbref.com/en/comps/9/2017-2018/defense/2017-2018-Premier-League-Stats"
"James Milner","Liverpool",2018,"eng ENG","MF",31,1986,19.7,58,45,18,32,8,15,39,38.5,24,33,5,28,21,79,23,0,"Matches","https://fbref.com/en/comps/9/2017-2018/defense/2017-2018-Premier-League-Stats"
"Tyrone Mings","Bournemouth",2018,"eng ENG","DF",24,1993,2.2,1,1,1,0,0,0,0,NA,0,2,2,0,6,7,13,1,"Matches","https://fbref.com/en/comps/9/2017-2018/defense/2017-2018-Premier-League-Stats"
"Kevin Mirallas","Everton",2018,"be BEL","FW,MF",29,1987,1.5,4,3,1,2,1,0,1,0,1,0,0,0,0,4,3,0,"Matches","https://fbref.com/en/comps/9/2017-2018/defense/2017-2018-Premier-League-Stats"
"Aleksandar Mitrovic","Newcastle Utd",2018,"rs SRB","FW",22,1994,1.1,1,1,0,1,0,0,1,0,1,1,0,1,0,1,2,0,"Matches","https://fbref.com/en/comps/9/2017-2018/defense/2017-2018-Premier-League-Stats"
"Henrikh Mkhitaryan","Arsenal",2018,"am ARM","FW,MF",28,1989,8.8,18,13,9,7,2,5,21,23.8,16,16,2,14,8,26,7,0,"Matches","https://fbref.com/en/comps/9/2017-2018/defense/2017-2018-Premier-League-Stats"
"Henrikh Mkhitaryan","Manchester Utd",2018,"am ARM","MF,FW",28,1989,10.2,15,11,4,7,4,5,25,20,20,8,0,8,7,22,3,0,"Matches","https://fbref.com/en/comps/9/2017-2018/defense/2017-2018-Premier-League-Stats"
"Nacho Monreal","Arsenal",2018,"es ESP","DF",31,1986,24.9,54,32,19,29,6,21,48,43.8,27,26,7,19,56,110,83,2,"Matches","https://fbref.com/en/comps/9/2017-2018/defense/2017-2018-Premier-League-Stats"
"Aaron Mooy","Huddersfield",2018,"au AUS","MF",26,1990,34.1,102,60,39,51,12,23,55,41.8,32,39,5,34,38,140,52,0,"Matches","https://fbref.com/en/comps/9/2017-2018/defense/2017-2018-Premier-League-Stats"
"Álvaro Morata","Chelsea",2018,"es ESP","FW",24,1992,22.9,13,8,0,7,6,1,21,4.8,20,17,4,13,6,19,20,0,"Matches","https://fbref.com/en/comps/9/2017-2018/defense/2017-2018-Premier-League-Stats"
"Alberto Moreno","Liverpool",2018,"es ESP","DF",25,1992,14.1,35,26,21,12,2,13,29,44.8,16,19,2,17,12,47,44,0,"Matches","https://fbref.com/en/comps/9/2017-2018/defense/2017-2018-Premier-League-Stats"
"Wes Morgan","Leicester City",2018,"jm JAM","DF",33,1984,31.3,35,25,26,8,1,12,18,66.7,6,41,27,14,31,66,146,1,"Matches","https://fbref.com/en/comps/9/2017-2018/defense/2017-2018-Premier-League-Stats"
"James Morrison","West Brom",2018,"sct SCO","MF",31,1986,2.3,2,1,0,2,0,1,4,25,3,1,1,0,1,3,1,0,"Matches","https://fbref.com/en/comps/9/2017-2018/defense/2017-2018-Premier-League-Stats"
"Victor Moses","Chelsea",2018,"ng NGA","DF,MF",26,1990,23.4,37,29,21,13,3,14,24,58.3,10,29,4,25,15,52,39,2,"Matches","https://fbref.com/en/comps/9/2017-2018/defense/2017-2018-Premier-League-Stats"
"Steve Mounié","Huddersfield",2018,"bj BEN","FW",22,1994,20.6,11,8,2,4,5,0,19,0,19,23,3,20,7,18,30,0,"Matches","https://fbref.com/en/comps/9/2017-2018/defense/2017-2018-Premier-League-Stats"
"Lucas Moura","Tottenham",2018,"br BRA","FW,MF",24,1992,2.3,4,2,3,0,1,1,3,33.3,2,2,0,2,2,6,2,0,"Matches","https://fbref.com/en/comps/9/2017-2018/defense/2017-2018-Premier-League-Stats"
"Lys Mousset","Bournemouth",2018,"fr FRA","FW,MF",21,1996,6.6,9,5,6,3,0,0,8,0,8,5,2,3,3,12,9,0,"Matches","https://fbref.com/en/comps/9/2017-2018/defense/2017-2018-Premier-League-Stats"
"Jacob Murphy","Newcastle Utd",2018,"eng ENG","MF,FW",22,1995,12.8,13,10,5,4,4,7,27,25.9,20,16,0,16,6,19,13,2,"Matches","https://fbref.com/en/comps/9/2017-2018/defense/2017-2018-Premier-League-Stats"
"Jamie Murphy","Brighton",2018,"sct SCO","MF",27,1989,1.9,2,2,2,0,0,2,4,50,2,0,0,0,1,3,3,0,"Matches","https://fbref.com/en/comps/9/2017-2018/defense/2017-2018-Premier-League-Stats"
"Glenn Murray","Brighton",2018,"eng ENG","FW",33,1983,24.4,18,12,4,11,3,2,18,11.1,16,16,4,12,5,23,27,0,"Matches","https://fbref.com/en/comps/9/2017-2018/defense/2017-2018-Premier-League-Stats"
"Charly Musonda Jr.","Chelsea",2018,"be BEL","FW",20,1996,0.4,1,0,0,0,1,1,1,100,0,0,0,0,0,1,0,0,"Matches","https://fbref.com/en/comps/9/2017-2018/defense/2017-2018-Premier-League-Stats"
"Shkodran Mustafi","Arsenal",2018,"de GER","DF",25,1992,25.3,64,46,42,18,4,28,54,51.9,26,23,15,8,57,121,175,2,"Matches","https://fbref.com/en/comps/9/2017-2018/defense/2017-2018-Premier-League-Stats"
"Boaz Myhill","West Brom",2018,"wls WAL","GK",34,1982,1,0,0,0,0,0,0,0,NA,0,0,0,0,0,0,1,0,"Matches","https://fbref.com/en/comps/9/2017-2018/defense/2017-2018-Premier-League-Stats"
"Georges-Kévin N'Koudou","Tottenham",2018,"cm CMR","MF",22,1995,0,0,0,0,0,0,0,0,NA,0,0,0,0,0,0,1,0,"Matches","https://fbref.com/en/comps/9/2017-2018/defense/2017-2018-Premier-League-Stats"
"Georges-Kévin N'Koudou","Burnley",2018,"cm CMR","MF,FW",22,1995,2.5,7,6,5,1,1,3,8,37.5,5,4,0,4,1,8,1,0,"Matches","https://fbref.com/en/comps/9/2017-2018/defense/2017-2018-Premier-League-Stats"
"Luciano Narsingh","Swansea City",2018,"nl NED","FW,MF",26,1990,6.9,7,5,1,5,1,2,7,28.6,5,7,0,7,3,10,3,0,"Matches","https://fbref.com/en/comps/9/2017-2018/defense/2017-2018-Premier-League-Stats"
"Kyle Naughton","Swansea City",2018,"eng ENG","DF",28,1988,33.7,92,60,49,35,8,54,100,54,46,60,13,47,60,152,144,4,"Matches","https://fbref.com/en/comps/9/2017-2018/defense/2017-2018-Premier-League-Stats"
"Badou Ndiaye","Stoke City",2018,"sn SEN","MF",26,1990,12.6,53,28,22,25,6,16,41,39,25,21,9,12,13,66,18,0,"Matches","https://fbref.com/en/comps/9/2017-2018/defense/2017-2018-Premier-League-Stats"
"Wilfred Ndidi","Leicester City",2018,"ng NGA","MF",20,1996,32.2,138,89,68,65,5,45,119,37.8,74,67,10,57,51,189,103,2,"Matches","https://fbref.com/en/comps/9/2017-2018/defense/2017-2018-Premier-League-Stats"
"Reiss Nelson","Arsenal",2018,"eng ENG","FW,MF",17,1999,1.6,4,3,1,1,2,0,0,NA,0,4,0,4,3,7,0,0,"Matches","https://fbref.com/en/comps/9/2017-2018/defense/2017-2018-Premier-League-Stats"
"Julien Ngoy","Stoke City",2018,"be BEL","MF",19,1997,0.2,1,1,0,1,0,1,2,50,1,0,0,0,0,1,0,0,"Matches","https://fbref.com/en/comps/9/2017-2018/defense/2017-2018-Premier-League-Stats"
"Oumar Niasse","Everton",2018,"sn SEN","FW",27,1990,12.1,10,6,2,5,3,4,19,21.1,15,3,2,1,2,12,6,0,"Matches","https://fbref.com/en/comps/9/2017-2018/defense/2017-2018-Premier-League-Stats"
"Eddie Nketiah","Arsenal",2018,"eng ENG","FW",18,1999,0.2,1,1,0,1,0,0,0,NA,0,0,0,0,0,1,0,0,"Matches","https://fbref.com/en/comps/9/2017-2018/defense/2017-2018-Premier-League-Stats"
"Lukas Nmecha","Manchester City",2018,"de GER","FW",18,1998,0.2,0,0,0,0,0,0,0,NA,0,0,0,0,0,0,0,0,"Matches","https://fbref.com/en/comps/9/2017-2018/defense/2017-2018-Premier-League-Stats"
"Mark Noble","West Ham",2018,"eng ENG","MF",30,1987,26.7,61,36,32,22,7,16,76,21.1,60,28,10,18,47,108,32,1,"Matches","https://fbref.com/en/comps/9/2017-2018/defense/2017-2018-Premier-League-Stats"
"Allan Nyom","West Brom",2018,"cm CMR","DF",29,1988,25.7,64,39,43,17,4,28,43,65.1,15,20,9,11,27,91,93,0,"Matches","https://fbref.com/en/comps/9/2017-2018/defense/2017-2018-Premier-League-Stats"
"Aiden O'Neill","Burnley",2018,"au AUS","MF",19,1998,0,NA,NA,NA,NA,NA,NA,NA,NA,NA,NA,NA,NA,NA,NA,NA,NA,"Matches","https://fbref.com/en/comps/9/2017-2018/defense/2017-2018-Premier-League-Stats"
"Michael Obafemi","Southampton",2018,"ie IRL","FW",17,2000,0.1,0,0,0,0,0,0,0,NA,0,0,0,0,0,0,0,0,"Matches","https://fbref.com/en/comps/9/2017-2018/defense/2017-2018-Premier-League-Stats"
"Pedro Obiang","West Ham",2018,"gq EQG","MF",25,1992,17.4,53,34,20,29,4,17,51,33.3,34,37,16,21,24,77,27,1,"Matches","https://fbref.com/en/comps/9/2017-2018/defense/2017-2018-Premier-League-Stats"
"Angelo Ogbonna","West Ham",2018,"it ITA","DF",29,1988,32,30,24,18,10,2,8,18,44.4,10,40,27,13,58,88,197,1,"Matches","https://fbref.com/en/comps/9/2017-2018/defense/2017-2018-Premier-League-Stats"
"Stefano Okaka","Watford",2018,"it ITA","FW",27,1989,5,6,4,0,6,0,3,6,50,3,3,0,3,0,6,0,0,"Matches","https://fbref.com/en/comps/9/2017-2018/defense/2017-2018-Premier-League-Stats"
"Shinji Okazaki","Leicester City",2018,"jp JPN","FW,MF",31,1986,14.7,25,16,3,18,4,4,28,14.3,24,15,1,14,8,33,6,0,"Matches","https://fbref.com/en/comps/9/2017-2018/defense/2017-2018-Premier-League-Stats"
"Martin Olsson","Swansea City",2018,"se SWE","DF",29,1988,35,34,26,18,10,6,12,29,41.4,17,21,4,17,31,65,81,0,"Matches","https://fbref.com/en/comps/9/2017-2018/defense/2017-2018-Premier-League-Stats"
"Divock Origi","Liverpool",2018,"be BEL","FW",22,1995,0.1,0,0,0,0,0,0,0,NA,0,0,0,0,0,0,0,0,"Matches","https://fbref.com/en/comps/9/2017-2018/defense/2017-2018-Premier-League-Stats"
"David Ospina","Arsenal",2018,"co COL","GK",28,1988,4.2,0,0,0,0,0,0,0,NA,0,0,0,0,0,0,1,0,"Matches","https://fbref.com/en/comps/9/2017-2018/defense/2017-2018-Premier-League-Stats"
"Nicolás Otamendi","Manchester City",2018,"ar ARG","DF",29,1988,33,58,43,35,22,1,19,44,43.2,25,21,10,11,48,106,129,3,"Matches","https://fbref.com/en/comps/9/2017-2018/defense/2017-2018-Premier-League-Stats"
"Reece Oxford","West Ham",2018,"eng ENG","MF",18,1998,0.1,2,1,1,1,0,1,1,100,0,0,0,0,0,2,0,0,"Matches","https://fbref.com/en/comps/9/2017-2018/defense/2017-2018-Premier-League-Stats"
"Alex Oxlade-Chamberlain","Arsenal",2018,"eng ENG","DF",23,1993,2.7,5,3,2,2,1,2,3,66.7,1,5,2,3,6,11,8,0,"Matches","https://fbref.com/en/comps/9/2017-2018/defense/2017-2018-Premier-League-Stats"
"Alex Oxlade-Chamberlain","Liverpool",2018,"eng ENG","MF,FW",23,1993,16.6,32,21,13,14,5,6,21,28.6,15,24,0,24,20,52,14,0,"Matches","https://fbref.com/en/comps/9/2017-2018/defense/2017-2018-Premier-League-Stats"
"Mesut Özil","Arsenal",2018,"de GER","MF,FW",28,1988,24,20,13,6,10,4,5,22,22.7,17,11,1,10,12,32,9,0,"Matches","https://fbref.com/en/comps/9/2017-2018/defense/2017-2018-Premier-League-Stats"
"Kasey Palmer","Huddersfield",2018,"jm JAM","MF,FW",20,1996,1.9,6,3,2,3,1,2,8,25,6,5,0,5,0,6,2,0,"Matches","https://fbref.com/en/comps/9/2017-2018/defense/2017-2018-Premier-League-Stats"
"Emerson Palmieri","Chelsea",2018,"it ITA","DF",22,1994,3.1,6,4,4,2,0,5,5,100,0,2,0,2,2,8,10,0,"Matches","https://fbref.com/en/comps/9/2017-2018/defense/2017-2018-Premier-League-Stats"
"Pedro","Chelsea",2018,"es ESP","MF,FW",30,1987,16.9,20,11,6,8,6,5,18,27.8,13,13,1,12,13,33,7,1,"Matches","https://fbref.com/en/comps/9/2017-2018/defense/2017-2018-Premier-League-Stats"
"Roberto Pereyra","Watford",2018,"ar ARG","MF,FW",26,1991,18,10,8,4,5,1,2,13,15.4,11,16,0,16,9,19,6,0,"Matches","https://fbref.com/en/comps/9/2017-2018/defense/2017-2018-Premier-League-Stats"
"Ayoze Pérez","Newcastle Utd",2018,"es ESP","MF,FW",24,1993,27.7,39,21,11,15,13,12,54,22.2,42,36,1,35,24,63,28,0,"Matches","https://fbref.com/en/comps/9/2017-2018/defense/2017-2018-Premier-League-Stats"
"Matt Phillips","West Brom",2018,"sct SCO","MF,DF",26,1991,23.3,27,16,17,5,5,10,29,34.5,19,21,1,20,24,51,43,0,"Matches","https://fbref.com/en/comps/9/2017-2018/defense/2017-2018-Premier-League-Stats"
"Jordan Pickford","Everton",2018,"eng ENG","GK",23,1994,38,0,0,0,0,0,0,2,0,2,0,0,0,2,2,26,5,"Matches","https://fbref.com/en/comps/9/2017-2018/defense/2017-2018-Premier-League-Stats"
"Jérémy Pied","Southampton",2018,"fr FRA","DF",28,1989,2,9,6,8,1,0,6,9,66.7,3,3,2,1,8,17,4,0,"Matches","https://fbref.com/en/comps/9/2017-2018/defense/2017-2018-Premier-League-Stats"
"Erik Pieters","Stoke City",2018,"nl NED","DF",28,1988,30.2,71,47,43,26,2,24,51,47.1,27,70,25,45,61,132,127,5,"Matches","https://fbref.com/en/comps/9/2017-2018/defense/2017-2018-Premier-League-Stats"
"Paul Pogba","Manchester Utd",2018,"fr FRA","MF",24,1993,23.9,33,23,13,15,5,5,33,15.2,28,16,0,16,21,54,26,0,"Matches","https://fbref.com/en/comps/9/2017-2018/defense/2017-2018-Premier-League-Stats"
"Nick Pope","Burnley",2018,"eng ENG","GK",25,1992,34.6,0,0,0,0,0,0,1,0,1,0,0,0,0,0,21,0,"Matches","https://fbref.com/en/comps/9/2017-2018/defense/2017-2018-Premier-League-Stats"
"Alex Pritchard","Huddersfield",2018,"eng ENG","MF,FW",24,1993,11.1,18,8,2,6,10,10,21,47.6,11,6,1,5,5,23,11,0,"Matches","https://fbref.com/en/comps/9/2017-2018/defense/2017-2018-Premier-League-Stats"
"Sebastian Prödl","Watford",2018,"at AUT","DF",30,1987,17.4,22,17,19,3,0,8,15,53.3,7,20,9,11,31,53,92,1,"Matches","https://fbref.com/en/comps/9/2017-2018/defense/2017-2018-Premier-League-Stats"
"Davy Pröpper","Brighton",2018,"nl NED","MF",25,1991,34.7,73,44,35,35,3,18,83,21.7,65,35,11,24,60,133,80,2,"Matches","https://fbref.com/en/comps/9/2017-2018/defense/2017-2018-Premier-League-Stats"
"Marc Pugh","Bournemouth",2018,"eng ENG","MF,FW",30,1987,10.9,7,3,2,4,1,2,10,20,8,6,1,5,13,20,13,2,"Matches","https://fbref.com/en/comps/9/2017-2018/defense/2017-2018-Premier-League-Stats"
"Jason Puncheon","Crystal Palace",2018,"eng ENG","MF",31,1986,7.2,13,4,3,7,3,1,5,20,4,3,0,3,5,18,4,0,"Matches","https://fbref.com/en/comps/9/2017-2018/defense/2017-2018-Premier-League-Stats"
"Collin Quaner","Huddersfield",2018,"de GER","FW,MF",26,1991,14.2,22,15,8,8,6,9,26,34.6,17,24,4,20,11,33,15,0,"Matches","https://fbref.com/en/comps/9/2017-2018/defense/2017-2018-Premier-League-Stats"
"Sandro Ramírez","Everton",2018,"es ESP","FW,MF",22,1995,3.1,2,1,0,1,1,0,3,0,3,1,0,1,1,3,0,0,"Matches","https://fbref.com/en/comps/9/2017-2018/defense/2017-2018-Premier-League-Stats"
"Aaron Ramsey","Arsenal",2018,"wls WAL","MF",26,1990,20.5,35,27,18,17,0,8,44,18.2,36,14,3,11,24,59,6,1,"Matches","https://fbref.com/en/comps/9/2017-2018/defense/2017-2018-Premier-League-Stats"
"Àngel Rangel","Swansea City",2018,"es ESP","DF",34,1982,1.7,4,3,2,2,0,1,3,33.3,2,0,0,0,3,7,4,0,"Matches","https://fbref.com/en/comps/9/2017-2018/defense/2017-2018-Premier-League-Stats"
"Marcus Rashford","Manchester Utd",2018,"eng ENG","FW,MF",19,1997,20.1,14,11,4,5,5,6,18,33.3,12,18,0,18,8,22,19,0,"Matches","https://fbref.com/en/comps/9/2017-2018/defense/2017-2018-Premier-League-Stats"
"Nathan Redmond","Southampton",2018,"eng ENG","FW,MF",23,1994,21.6,32,17,16,14,2,12,31,38.7,19,20,0,20,15,47,17,2,"Matches","https://fbref.com/en/comps/9/2017-2018/defense/2017-2018-Premier-League-Stats"
"Winston Reid","West Ham",2018,"nz NZL","DF",29,1988,16.1,11,9,7,4,0,4,15,26.7,11,27,14,13,22,33,104,0,"Matches","https://fbref.com/en/comps/9/2017-2018/defense/2017-2018-Premier-League-Stats"
"Declan Rice","West Ham",2018,"eng ENG","DF,MF",18,1999,15.9,36,24,25,10,1,15,25,60,10,19,13,6,27,63,77,1,"Matches","https://fbref.com/en/comps/9/2017-2018/defense/2017-2018-Premier-League-Stats"
"Richarlison","Watford",2018,"br BRA","FW,MF",20,1997,31.4,64,44,26,28,10,10,39,25.6,29,39,5,34,24,88,32,1,"Matches","https://fbref.com/en/comps/9/2017-2018/defense/2017-2018-Premier-League-Stats"
"Jaïro Riedewald","Crystal Palace",2018,"nl NED","MF,DF",20,1996,4.9,11,8,6,4,1,0,2,0,2,7,1,6,12,23,13,0,"Matches","https://fbref.com/en/comps/9/2017-2018/defense/2017-2018-Premier-League-Stats"
"Matt Ritchie","Newcastle Utd",2018,"sct SCO","MF,FW",27,1989,31.2,46,32,22,18,6,14,53,26.4,39,37,5,32,35,81,63,1,"Matches","https://fbref.com/en/comps/9/2017-2018/defense/2017-2018-Premier-League-Stats"
"Connor Roberts","Swansea City",2018,"wls WAL","DF",21,1995,3,6,4,5,1,0,3,3,100,0,2,0,2,3,9,6,0,"Matches","https://fbref.com/en/comps/9/2017-2018/defense/2017-2018-Premier-League-Stats"
"Andrew Robertson","Liverpool",2018,"sct SCO","DF",23,1994,21.6,31,17,19,9,3,15,29,51.7,14,22,2,20,26,57,56,0,"Matches","https://fbref.com/en/comps/9/2017-2018/defense/2017-2018-Premier-League-Stats"
"Hal Robson-Kanu","West Brom",2018,"wls WAL","FW,MF",28,1989,9.2,5,4,1,2,2,0,13,0,13,9,3,6,4,9,9,0,"Matches","https://fbref.com/en/comps/9/2017-2018/defense/2017-2018-Premier-League-Stats"
"Jay Rodriguez","West Brom",2018,"eng ENG","FW,MF",28,1989,31.2,31,21,12,11,8,9,50,18,41,32,2,30,19,50,41,0,"Matches","https://fbref.com/en/comps/9/2017-2018/defense/2017-2018-Premier-League-Stats"
"Marcos Rojo","Manchester Utd",2018,"ar ARG","DF",27,1990,7.1,7,5,6,0,1,1,8,12.5,7,11,6,5,7,14,56,2,"Matches","https://fbref.com/en/comps/9/2017-2018/defense/2017-2018-Premier-League-Stats"
"Sergio Romero","Manchester Utd",2018,"ar ARG","GK",30,1987,1,0,0,0,0,0,0,0,NA,0,0,0,0,0,0,0,0,"Matches","https://fbref.com/en/comps/9/2017-2018/defense/2017-2018-Premier-League-Stats"
"Oriol Romeu","Southampton",2018,"es ESP","MF",25,1991,32.2,93,64,41,44,8,32,100,32,68,59,19,40,69,162,77,2,"Matches","https://fbref.com/en/comps/9/2017-2018/defense/2017-2018-Premier-League-Stats"
"Salomón Rondón","West Brom",2018,"ve VEN","FW",27,1989,30.7,14,6,0,7,7,5,26,19.2,21,27,0,27,14,28,20,0,"Matches","https://fbref.com/en/comps/9/2017-2018/defense/2017-2018-Premier-League-Stats"
"Wayne Rooney","Everton",2018,"eng ENG","MF,FW",31,1985,25.2,28,19,11,13,4,10,42,23.8,32,25,6,19,16,44,43,2,"Matches","https://fbref.com/en/comps/9/2017-2018/defense/2017-2018-Premier-League-Stats"
"Danny Rose","Tottenham",2018,"eng ENG","DF",27,1990,8.9,15,11,6,7,2,8,15,53.3,7,12,6,6,9,24,15,0,"Matches","https://fbref.com/en/comps/9/2017-2018/defense/2017-2018-Premier-League-Stats"
"Liam Rosenior","Brighton",2018,"eng ENG","DF",33,1984,1.8,4,3,2,1,1,2,5,40,3,2,1,1,4,8,7,0,"Matches","https://fbref.com/en/comps/9/2017-2018/defense/2017-2018-Premier-League-Stats"
"Wayne Routledge","Swansea City",2018,"eng ENG","MF,FW",32,1985,4.8,10,5,2,6,2,2,8,25,6,5,0,5,2,12,5,0,"Matches","https://fbref.com/en/comps/9/2017-2018/defense/2017-2018-Premier-League-Stats"
"Antonio Rüdiger","Chelsea",2018,"de GER","DF",24,1993,26,31,21,20,10,1,15,31,48.4,16,29,15,14,24,55,115,1,"Matches","https://fbref.com/en/comps/9/2017-2018/defense/2017-2018-Premier-League-Stats"
"Mathew Ryan","Brighton",2018,"au AUS","GK",25,1992,38,0,0,0,0,0,0,3,0,3,0,0,0,3,3,10,3,"Matches","https://fbref.com/en/comps/9/2017-2018/defense/2017-2018-Premier-League-Stats"
"Abdelhamid Sabiri","Huddersfield",2018,"ma MAR","MF",20,1996,2.4,5,4,2,0,3,1,7,14.3,6,4,0,4,1,6,2,0,"Matches","https://fbref.com/en/comps/9/2017-2018/defense/2017-2018-Premier-League-Stats"
"Henri Saivet","Newcastle Utd",2018,"sn SEN","MF",26,1990,0.9,5,3,4,1,0,2,5,40,3,0,0,0,4,9,8,1,"Matches","https://fbref.com/en/comps/9/2017-2018/defense/2017-2018-Premier-League-Stats"
"Diafra Sakho","West Ham",2018,"sn SEN","FW",27,1989,3.4,5,2,1,4,0,0,3,0,3,3,0,3,1,6,2,0,"Matches","https://fbref.com/en/comps/9/2017-2018/defense/2017-2018-Premier-League-Stats"
"Mamadou Sakho","Crystal Palace",2018,"fr FRA","DF",27,1990,17.8,21,14,15,5,1,9,16,56.3,7,19,11,8,30,51,101,3,"Matches","https://fbref.com/en/comps/9/2017-2018/defense/2017-2018-Premier-League-Stats"
"Bakary Sako","Crystal Palace",2018,"ml MLI","FW,MF",29,1988,5.3,7,6,5,0,2,2,9,22.2,7,2,0,2,1,8,2,0,"Matches","https://fbref.com/en/comps/9/2017-2018/defense/2017-2018-Premier-League-Stats"
"Mohamed Salah","Liverpool",2018,"eg EGY","FW",25,1992,32.3,12,6,2,5,5,3,23,13,20,10,0,10,5,17,5,0,"Matches","https://fbref.com/en/comps/9/2017-2018/defense/2017-2018-Premier-League-Stats"
"Renato Sanches","Swansea City",2018,"pt POR","MF",19,1997,7.8,12,7,6,6,0,6,18,33.3,12,9,1,8,7,19,5,1,"Matches","https://fbref.com/en/comps/9/2017-2018/defense/2017-2018-Premier-League-Stats"
"Alexis Sánchez","Arsenal",2018,"cl CHI","MF,FW",28,1988,16.7,20,9,9,4,7,7,32,21.9,25,5,2,3,6,26,1,0,"Matches","https://fbref.com/en/comps/9/2017-2018/defense/2017-2018-Premier-League-Stats"
"Alexis Sánchez","Manchester Utd",2018,"cl CHI","FW,MF",28,1988,11.6,21,17,10,4,7,4,27,14.8,23,8,0,8,17,38,0,0,"Matches","https://fbref.com/en/comps/9/2017-2018/defense/2017-2018-Premier-League-Stats"
"Davinson Sánchez","Tottenham",2018,"co COL","DF",21,1996,28.2,38,24,28,9,1,18,40,45,22,26,10,16,38,76,162,0,"Matches","https://fbref.com/en/comps/9/2017-2018/defense/2017-2018-Premier-League-Stats"
"Leroy Sané","Manchester City",2018,"de GER","FW",21,1996,26.9,27,21,14,7,6,8,22,36.4,14,22,1,21,13,40,6,0,"Matches","https://fbref.com/en/comps/9/2017-2018/defense/2017-2018-Premier-League-Stats"
"Ezequiel Schelotto","Brighton",2018,"it ITA","DF",28,1989,14.6,20,13,14,6,0,12,27,44.4,15,7,3,4,19,39,58,2,"Matches","https://fbref.com/en/comps/9/2017-2018/defense/2017-2018-Premier-League-Stats"
"Christopher Schindler","Huddersfield",2018,"de GER","DF",27,1990,36.3,83,61,56,27,0,24,41,58.5,17,54,30,24,75,158,275,1,"Matches","https://fbref.com/en/comps/9/2017-2018/defense/2017-2018-Premier-League-Stats"
"Jeffrey Schlupp","Crystal Palace",2018,"gh GHA","DF,MF",24,1992,19.4,57,36,35,20,2,23,43,53.5,20,34,8,26,24,81,67,0,"Matches","https://fbref.com/en/comps/9/2017-2018/defense/2017-2018-Premier-League-Stats"
"Kasper Schmeichel","Leicester City",2018,"dk DEN","GK",30,1986,32.9,1,0,1,0,0,1,3,33.3,2,1,0,1,0,1,18,5,"Matches","https://fbref.com/en/comps/9/2017-2018/defense/2017-2018-Premier-League-Stats"
"Morgan Schneiderlin","Everton",2018,"fr FRA","MF",27,1989,23.7,58,40,34,21,3,15,44,34.1,29,18,7,11,61,119,59,1,"Matches","https://fbref.com/en/comps/9/2017-2018/defense/2017-2018-Premier-League-Stats"
"Xherdan Shaqiri","Stoke City",2018,"ch SUI","MF,FW",25,1991,33.8,25,17,9,11,5,10,39,25.6,29,9,1,8,16,41,6,2,"Matches","https://fbref.com/en/comps/9/2017-2018/defense/2017-2018-Premier-League-Stats"
"Luke Shaw","Manchester Utd",2018,"eng ENG","DF",22,1995,8.8,18,15,10,7,1,11,18,61.1,7,16,2,14,4,22,22,1,"Matches","https://fbref.com/en/comps/9/2017-2018/defense/2017-2018-Premier-League-Stats"
"Ryan Shawcross","Stoke City",2018,"eng ENG","DF",29,1987,26.3,36,20,25,9,2,13,25,52,12,33,23,10,40,76,224,1,"Matches","https://fbref.com/en/comps/9/2017-2018/defense/2017-2018-Premier-League-Stats"
"Jonjo Shelvey","Newcastle Utd",2018,"eng ENG","MF",25,1992,25.2,39,24,17,21,1,8,26,30.8,18,26,5,21,28,67,33,0,"Matches","https://fbref.com/en/comps/9/2017-2018/defense/2017-2018-Premier-League-Stats"
"Gylfi Sigurðsson","Everton",2018,"is ISL","MF,FW",27,1989,25.1,38,26,15,14,9,16,57,28.1,41,37,7,30,34,72,36,0,"Matches","https://fbref.com/en/comps/9/2017-2018/defense/2017-2018-Premier-League-Stats"
"Adrien Silva","Leicester City",2018,"pt POR","MF",28,1989,8.5,22,13,8,13,1,6,28,21.4,22,12,2,10,14,36,0,0,"Matches","https://fbref.com/en/comps/9/2017-2018/defense/2017-2018-Premier-League-Stats"
"Bernardo Silva","Manchester City",2018,"pt POR","FW,MF",22,1994,17,27,18,11,9,7,6,30,20,24,17,1,16,10,37,12,1,"Matches","https://fbref.com/en/comps/9/2017-2018/defense/2017-2018-Premier-League-Stats"
"David Silva","Manchester City",2018,"es ESP","MF",31,1986,27,32,21,11,17,4,9,45,20,36,28,5,23,18,50,7,0,"Matches","https://fbref.com/en/comps/9/2017-2018/defense/2017-2018-Premier-League-Stats"
"Danny Simpson","Leicester City",2018,"eng ENG","DF",30,1987,25.6,38,22,31,6,1,22,45,48.9,23,31,19,12,34,72,132,1,"Matches","https://fbref.com/en/comps/9/2017-2018/defense/2017-2018-Premier-League-Stats"
"Jack Simpson","Bournemouth",2018,"eng ENG","DF",20,1996,0.8,1,1,1,0,0,0,1,0,1,1,0,1,0,1,4,0,"Matches","https://fbref.com/en/comps/9/2017-2018/defense/2017-2018-Premier-League-Stats"
"Josh Sims","Southampton",2018,"eng ENG","FW,MF",20,1997,1.8,4,3,1,2,1,2,7,28.6,5,5,0,5,1,5,0,0,"Matches","https://fbref.com/en/comps/9/2017-2018/defense/2017-2018-Premier-League-Stats"
"Jerome Sinclair","Watford",2018,"eng ENG","MF,FW",20,1996,0.3,0,0,0,0,0,0,1,0,1,0,0,0,1,1,0,0,"Matches","https://fbref.com/en/comps/9/2017-2018/defense/2017-2018-Premier-League-Stats"
"Moussa Sissoko","Tottenham",2018,"fr FRA","MF,FW",27,1989,15.4,23,17,14,5,4,9,12,75,3,11,1,10,9,32,23,1,"Matches","https://fbref.com/en/comps/9/2017-2018/defense/2017-2018-Premier-League-Stats"
"Islam Slimani","Leicester City",2018,"dz ALG","FW",29,1988,2.8,2,2,1,1,0,1,4,25,3,2,0,2,0,2,2,0,"Matches","https://fbref.com/en/comps/9/2017-2018/defense/2017-2018-Premier-League-Stats"
"Islam Slimani","Newcastle Utd",2018,"dz ALG","FW",29,1988,1.5,0,0,0,0,0,0,2,0,2,0,0,0,1,1,1,0,"Matches","https://fbref.com/en/comps/9/2017-2018/defense/2017-2018-Premier-League-Stats"
"Chris Smalling","Manchester Utd",2018,"eng ENG","DF",27,1989,28.2,40,25,28,12,0,16,28,57.1,12,32,28,4,63,103,162,1,"Matches","https://fbref.com/en/comps/9/2017-2018/defense/2017-2018-Premier-League-Stats"
"Adam Smith","Bournemouth",2018,"eng ENG","DF,MF",26,1991,23,50,36,33,16,1,24,53,45.3,29,46,8,38,31,81,73,0,"Matches","https://fbref.com/en/comps/9/2017-2018/defense/2017-2018-Premier-League-Stats"
"Tommy Smith","Huddersfield",2018,"eng ENG","DF",25,1992,21.2,38,27,18,14,6,23,36,63.9,13,22,6,16,26,64,80,3,"Matches","https://fbref.com/en/comps/9/2017-2018/defense/2017-2018-Premier-League-Stats"
"Cédric Soares","Southampton",2018,"pt POR","DF",25,1991,31,54,34,40,10,4,22,31,71,9,32,8,24,24,78,109,2,"Matches","https://fbref.com/en/comps/9/2017-2018/defense/2017-2018-Premier-League-Stats"
"Ramadan Sobhi","Stoke City",2018,"eg EGY","MF,FW",20,1997,13.8,32,21,17,14,1,11,36,30.6,25,14,0,14,14,46,14,0,"Matches","https://fbref.com/en/comps/9/2017-2018/defense/2017-2018-Premier-League-Stats"
"Dominic Solanke","Liverpool",2018,"eng ENG","FW",19,1997,6.6,7,4,0,6,1,1,4,25,3,5,1,4,2,9,9,0,"Matches","https://fbref.com/en/comps/9/2017-2018/defense/2017-2018-Premier-League-Stats"
"Pape Souaré","Crystal Palace",2018,"sn SEN","DF",27,1990,0.1,0,0,0,0,0,0,0,NA,0,0,0,0,0,0,0,0,"Matches","https://fbref.com/en/comps/9/2017-2018/defense/2017-2018-Premier-League-Stats"
"Julián Speroni","Crystal Palace",2018,"ar ARG","GK",38,1979,11,0,0,0,0,0,0,0,NA,0,0,0,0,1,1,4,0,"Matches","https://fbref.com/en/comps/9/2017-2018/defense/2017-2018-Premier-League-Stats"
"Kostas Stafylidis","Stoke City",2018,"gr GRE","DF,MF",23,1993,3.7,12,6,6,4,2,6,9,66.7,3,7,2,5,5,17,19,0,"Matches","https://fbref.com/en/comps/9/2017-2018/defense/2017-2018-Premier-League-Stats"
"Junior Stanislas","Bournemouth",2018,"eng ENG","MF,FW",27,1989,14.3,16,8,8,4,4,7,15,46.7,8,21,6,15,6,22,15,0,"Matches","https://fbref.com/en/comps/9/2017-2018/defense/2017-2018-Premier-League-Stats"
"Dale Stephens","Brighton",2018,"eng ENG","MF",28,1989,36,104,62,63,39,2,32,114,28.1,82,53,16,37,63,167,69,1,"Matches","https://fbref.com/en/comps/9/2017-2018/defense/2017-2018-Premier-League-Stats"
"Jack Stephens","Southampton",2018,"eng ENG","DF",23,1994,22,29,20,24,5,0,13,25,52,12,30,18,12,41,70,108,2,"Matches","https://fbref.com/en/comps/9/2017-2018/defense/2017-2018-Premier-League-Stats"
"Raheem Sterling","Manchester City",2018,"eng ENG","FW",22,1994,28.7,19,14,7,7,5,3,32,9.4,29,24,0,24,9,28,9,0,"Matches","https://fbref.com/en/comps/9/2017-2018/defense/2017-2018-Premier-League-Stats"
"John Stones","Manchester City",2018,"eng ENG","DF",23,1994,14.5,15,11,11,4,0,4,11,36.4,7,8,5,3,19,34,44,0,"Matches","https://fbref.com/en/comps/9/2017-2018/defense/2017-2018-Premier-League-Stats"
"Daniel Sturridge","West Brom",2018,"eng ENG","FW",27,1989,1.3,0,0,0,0,0,0,0,NA,0,0,0,0,0,0,0,0,"Matches","https://fbref.com/en/comps/9/2017-2018/defense/2017-2018-Premier-League-Stats"
"Daniel Sturridge","Liverpool",2018,"eng ENG","FW",27,1989,4.8,0,0,0,0,0,0,1,0,1,1,0,1,0,0,1,0,"Matches","https://fbref.com/en/comps/9/2017-2018/defense/2017-2018-Premier-League-Stats"
"Ki Sung-yueng","Swansea City",2018,"kr KOR","MF",28,1989,20.8,25,18,10,13,2,4,16,25,12,16,1,15,32,57,23,0,"Matches","https://fbref.com/en/comps/9/2017-2018/defense/2017-2018-Premier-League-Stats"
"Andrew Surman","Bournemouth",2018,"eng ENG","MF",30,1986,20.6,16,12,5,8,3,6,23,26.1,17,33,12,21,16,32,52,2,"Matches","https://fbref.com/en/comps/9/2017-2018/defense/2017-2018-Premier-League-Stats"
"Markus Suttner","Brighton",2018,"at AUT","DF",30,1987,13.1,25,15,18,4,3,10,22,45.5,12,16,2,14,12,37,49,1,"Matches","https://fbref.com/en/comps/9/2017-2018/defense/2017-2018-Premier-League-Stats"
"Lasse Sørensen","Stoke City",2018,"dk DEN","MF",17,1999,0.8,2,2,2,0,0,1,5,20,4,2,0,2,0,2,3,0,"Matches","https://fbref.com/en/comps/9/2017-2018/defense/2017-2018-Premier-League-Stats"
"Alexander Sørloth","Crystal Palace",2018,"no NOR","FW",21,1995,4,6,3,1,4,1,4,12,33.3,8,5,0,5,2,8,5,0,"Matches","https://fbref.com/en/comps/9/2017-2018/defense/2017-2018-Premier-League-Stats"
"Duan Tadic","Southampton",2018,"rs SRB","MF,FW",28,1988,31,46,29,16,22,8,11,35,31.4,24,38,2,36,19,65,29,1,"Matches","https://fbref.com/en/comps/9/2017-2018/defense/2017-2018-Premier-League-Stats"
"Matt Targett","Southampton",2018,"eng ENG","DF",21,1995,1.8,6,3,5,0,1,1,3,33.3,2,3,2,1,3,9,7,1,"Matches","https://fbref.com/en/comps/9/2017-2018/defense/2017-2018-Premier-League-Stats"
"James Tarkowski","Burnley",2018,"eng ENG","DF",24,1992,31,46,26,36,10,0,17,38,44.7,21,55,43,12,50,96,223,2,"Matches","https://fbref.com/en/comps/9/2017-2018/defense/2017-2018-Premier-League-Stats"
"Charlie Taylor","Burnley",2018,"eng ENG","DF",23,1993,10.6,16,4,9,6,1,7,12,58.3,5,13,5,8,15,31,52,0,"Matches","https://fbref.com/en/comps/9/2017-2018/defense/2017-2018-Premier-League-Stats"
"James Tomkins","Crystal Palace",2018,"eng ENG","DF",28,1989,26.5,47,26,36,10,1,16,31,51.6,15,24,12,12,63,110,216,1,"Matches","https://fbref.com/en/comps/9/2017-2018/defense/2017-2018-Premier-League-Stats"
"Cenk Tosun","Everton",2018,"tr TUR","FW",26,1991,11,6,3,2,2,2,1,11,9.1,10,9,4,5,1,7,13,0,"Matches","https://fbref.com/en/comps/9/2017-2018/defense/2017-2018-Premier-League-Stats"
"Yaya Touré","Manchester City",2018,"ci CIV","MF",34,1983,2.6,2,2,1,0,1,1,1,100,0,3,1,2,5,7,4,0,"Matches","https://fbref.com/en/comps/9/2017-2018/defense/2017-2018-Premier-League-Stats"
"Andros Townsend","Crystal Palace",2018,"eng ENG","FW,MF",26,1991,34.7,60,34,35,12,13,24,75,32,51,49,1,48,35,95,28,0,"Matches","https://fbref.com/en/comps/9/2017-2018/defense/2017-2018-Premier-League-Stats"
"Kieran Trippier","Tottenham",2018,"eng ENG","DF",26,1990,21.3,52,30,29,21,2,21,44,47.7,23,31,6,25,20,72,53,1,"Matches","https://fbref.com/en/comps/9/2017-2018/defense/2017-2018-Premier-League-Stats"
"Axel Tuanzebe","Manchester Utd",2018,"eng ENG","FW",19,1997,0,0,0,0,0,0,0,0,NA,0,0,0,0,0,0,0,0,"Matches","https://fbref.com/en/comps/9/2017-2018/defense/2017-2018-Premier-League-Stats"
"Josh Tymon","Stoke City",2018,"eng ENG","DF",18,1999,1.8,5,1,4,1,0,2,3,66.7,1,1,0,1,1,6,3,0,"Matches","https://fbref.com/en/comps/9/2017-2018/defense/2017-2018-Premier-League-Stats"
"Leonardo Ulloa","Leicester City",2018,"ar ARG","FW",31,1986,0.2,1,0,0,0,1,0,0,NA,0,0,0,0,0,1,1,0,"Matches","https://fbref.com/en/comps/9/2017-2018/defense/2017-2018-Premier-League-Stats"
"Leonardo Ulloa","Brighton",2018,"ar ARG","FW",31,1986,3,3,1,0,1,2,1,7,14.3,6,1,0,1,0,3,3,0,"Matches","https://fbref.com/en/comps/9/2017-2018/defense/2017-2018-Premier-League-Stats"
"Antonio Valencia","Manchester Utd",2018,"ec ECU","DF",31,1985,30.4,57,32,21,28,8,16,36,44.4,20,47,6,41,48,105,80,0,"Matches","https://fbref.com/en/comps/9/2017-2018/defense/2017-2018-Premier-League-Stats"
"Virgil van Dijk","Southampton",2018,"nl NED","DF",26,1991,11,10,7,6,2,2,2,3,66.7,1,14,13,1,29,39,81,1,"Matches","https://fbref.com/en/comps/9/2017-2018/defense/2017-2018-Premier-League-Stats"
"Virgil van Dijk","Liverpool",2018,"nl NED","DF",26,1991,14,15,8,7,7,1,4,5,80,1,8,2,6,18,33,80,1,"Matches","https://fbref.com/en/comps/9/2017-2018/defense/2017-2018-Premier-League-Stats"
"Jamie Vardy","Leicester City",2018,"eng ENG","FW",30,1987,36.1,15,9,3,7,5,1,8,12.5,7,21,1,20,2,17,17,0,"Matches","https://fbref.com/en/comps/9/2017-2018/defense/2017-2018-Premier-League-Stats"
"Jan Vertonghen","Tottenham",2018,"be BEL","DF",30,1987,35.6,64,41,40,20,4,25,36,69.4,11,29,11,18,60,124,177,0,"Matches","https://fbref.com/en/comps/9/2017-2018/defense/2017-2018-Premier-League-Stats"
"Nikola Vlaic","Everton",2018,"hr CRO","MF,FW",19,1997,6.4,9,5,3,6,0,2,9,22.2,7,14,2,12,9,18,10,0,"Matches","https://fbref.com/en/comps/9/2017-2018/defense/2017-2018-Premier-League-Stats"
"Sam Vokes","Burnley",2018,"wls WAL","FW",27,1989,11.1,3,1,1,2,0,0,3,0,3,6,2,4,3,6,15,0,"Matches","https://fbref.com/en/comps/9/2017-2018/defense/2017-2018-Premier-League-Stats"
"Michel Vorm","Tottenham",2018,"nl NED","GK",33,1983,1,0,0,0,0,0,0,0,NA,0,0,0,0,0,0,1,0,"Matches","https://fbref.com/en/comps/9/2017-2018/defense/2017-2018-Premier-League-Stats"
"Molla Wagué","Watford",2018,"ml MLI","DF",26,1991,4.9,5,3,3,2,0,2,5,40,3,1,0,1,9,14,30,0,"Matches","https://fbref.com/en/comps/9/2017-2018/defense/2017-2018-Premier-League-Stats"
"Theo Walcott","Arsenal",2018,"eng ENG","FW,MF",28,1989,0.8,1,0,1,0,0,0,0,NA,0,0,0,0,1,2,0,0,"Matches","https://fbref.com/en/comps/9/2017-2018/defense/2017-2018-Premier-League-Stats"
"Theo Walcott","Everton",2018,"eng ENG","FW",28,1989,12.8,27,19,12,13,2,7,15,46.7,8,9,0,9,8,35,12,0,"Matches","https://fbref.com/en/comps/9/2017-2018/defense/2017-2018-Premier-League-Stats"
"Kyle Walker","Manchester City",2018,"eng ENG","DF",27,1990,30.9,47,31,20,21,6,18,31,58.1,13,21,2,19,29,76,75,2,"Matches","https://fbref.com/en/comps/9/2017-2018/defense/2017-2018-Premier-League-Stats"
"Kyle Walker-Peters","Tottenham",2018,"eng ENG","DF",20,1997,2.1,5,4,4,1,0,2,4,50,2,2,0,2,3,8,8,0,"Matches","https://fbref.com/en/comps/9/2017-2018/defense/2017-2018-Premier-League-Stats"
"Jonathan Walters","Burnley",2018,"ie IRL","FW",33,1983,0.4,0,0,0,0,0,0,0,NA,0,0,0,0,0,0,1,0,"Matches","https://fbref.com/en/comps/9/2017-2018/defense/2017-2018-Premier-League-Stats"
"Aaron Wan-Bissaka","Crystal Palace",2018,"eng ENG","DF",19,1997,7,30,19,20,7,3,15,19,78.9,4,18,7,11,15,45,45,0,"Matches","https://fbref.com/en/comps/9/2017-2018/defense/2017-2018-Premier-League-Stats"
"Victor Wanyama","Tottenham",2018,"ke KEN","MF",26,1991,9.4,30,20,13,16,1,14,31,45.2,17,13,3,10,10,40,20,1,"Matches","https://fbref.com/en/comps/9/2017-2018/defense/2017-2018-Premier-League-Stats"
"Joel Ward","Crystal Palace",2018,"eng ENG","DF",27,1989,17.9,35,30,23,12,0,16,28,57.1,12,27,11,16,28,63,76,0,"Matches","https://fbref.com/en/comps/9/2017-2018/defense/2017-2018-Premier-League-Stats"
"Stephen Ward","Burnley",2018,"ie IRL","DF",31,1985,27.3,39,31,27,8,4,20,42,47.6,22,27,12,15,42,81,126,0,"Matches","https://fbref.com/en/comps/9/2017-2018/defense/2017-2018-Premier-League-Stats"
"James Ward-Prowse","Southampton",2018,"eng ENG","FW,MF",22,1994,19.1,23,16,9,11,3,3,27,11.1,24,29,1,28,8,31,31,0,"Matches","https://fbref.com/en/comps/9/2017-2018/defense/2017-2018-Premier-League-Stats"
"Ben Watson","Watford",2018,"eng ENG","MF",32,1985,5.1,19,9,9,9,1,10,31,32.3,21,6,1,5,7,26,10,0,"Matches","https://fbref.com/en/comps/9/2017-2018/defense/2017-2018-Premier-League-Stats"
"Danny Welbeck","Arsenal",2018,"eng ENG","FW,MF",26,1990,13.3,20,13,9,5,6,4,12,33.3,8,22,1,21,11,31,13,0,"Matches","https://fbref.com/en/comps/9/2017-2018/defense/2017-2018-Premier-League-Stats"
"Nahki Wells","Burnley",2018,"bm BER","FW,MF",27,1990,0.6,4,3,0,3,1,1,1,100,0,2,0,2,0,4,0,0,"Matches","https://fbref.com/en/comps/9/2017-2018/defense/2017-2018-Premier-League-Stats"
"Ashley Westwood","Burnley",2018,"eng ENG","MF",27,1990,12.3,13,10,10,3,0,2,16,12.5,14,17,9,8,19,32,16,0,"Matches","https://fbref.com/en/comps/9/2017-2018/defense/2017-2018-Premier-League-Stats"
"Dean Whitehead","Huddersfield",2018,"eng ENG","MF",35,1982,0.8,0,0,0,0,0,0,1,0,1,1,0,1,2,2,0,0,"Matches","https://fbref.com/en/comps/9/2017-2018/defense/2017-2018-Premier-League-Stats"
"Georginio Wijnaldum","Liverpool",2018,"nl NED","MF",26,1990,26.5,34,23,13,16,5,11,23,47.8,12,20,2,18,25,59,20,0,"Matches","https://fbref.com/en/comps/9/2017-2018/defense/2017-2018-Premier-League-Stats"
"Ashley Williams","Everton",2018,"wls WAL","DF",32,1984,20.4,23,13,17,6,0,9,18,50,9,31,23,8,36,59,173,3,"Matches","https://fbref.com/en/comps/9/2017-2018/defense/2017-2018-Premier-League-Stats"
"Danny Williams","Huddersfield",2018,"us USA","MF",28,1989,12.5,23,14,13,9,1,7,22,31.8,15,12,2,10,26,49,27,0,"Matches","https://fbref.com/en/comps/9/2017-2018/defense/2017-2018-Premier-League-Stats"
"Willian","Chelsea",2018,"br BRA","MF,FW",28,1988,21,22,17,7,12,3,0,16,0,16,13,1,12,10,32,10,0,"Matches","https://fbref.com/en/comps/9/2017-2018/defense/2017-2018-Premier-League-Stats"
"Joe Willock","Arsenal",2018,"eng ENG","MF",17,1999,0.9,4,2,4,0,0,1,1,100,0,3,0,3,1,5,2,0,"Matches","https://fbref.com/en/comps/9/2017-2018/defense/2017-2018-Premier-League-Stats"
"Jack Wilshere","Arsenal",2018,"eng ENG","MF",25,1992,13.3,15,10,3,7,5,4,20,20,16,10,2,8,8,23,5,0,"Matches","https://fbref.com/en/comps/9/2017-2018/defense/2017-2018-Premier-League-Stats"
"Callum Wilson","Bournemouth",2018,"eng ENG","FW",25,1992,22,9,5,2,6,1,1,14,7.1,13,15,3,12,3,12,15,0,"Matches","https://fbref.com/en/comps/9/2017-2018/defense/2017-2018-Premier-League-Stats"
"Kevin Wimmer","Stoke City",2018,"at AUT","DF",24,1992,14.7,24,17,17,7,0,9,20,45,11,25,12,13,30,54,88,0,"Matches","https://fbref.com/en/comps/9/2017-2018/defense/2017-2018-Premier-League-Stats"
"Harry Winks","Tottenham",2018,"eng ENG","MF",21,1996,8.6,15,12,8,5,2,8,16,50,8,12,2,10,11,26,10,1,"Matches","https://fbref.com/en/comps/9/2017-2018/defense/2017-2018-Premier-League-Stats"
"Chris Wood","Burnley",2018,"nz NZL","FW",25,1991,18,7,3,2,3,2,3,13,23.1,10,12,4,8,0,7,16,0,"Matches","https://fbref.com/en/comps/9/2017-2018/defense/2017-2018-Premier-League-Stats"
"Ben Woodburn","Liverpool",2018,"wls WAL","FW",17,1999,0.1,0,0,0,0,0,0,0,NA,0,0,0,0,0,0,0,0,"Matches","https://fbref.com/en/comps/9/2017-2018/defense/2017-2018-Premier-League-Stats"
"Granit Xhaka","Arsenal",2018,"ch SUI","MF",24,1992,36.2,78,57,35,40,3,26,69,37.7,43,30,9,21,37,115,68,4,"Matches","https://fbref.com/en/comps/9/2017-2018/defense/2017-2018-Premier-League-Stats"
"Claudio Yacob","West Brom",2018,"ar ARG","MF",30,1987,10,36,27,23,13,0,13,27,48.1,14,14,6,8,16,52,25,2,"Matches","https://fbref.com/en/comps/9/2017-2018/defense/2017-2018-Premier-League-Stats"
"DeAndre Yedlin","Newcastle Utd",2018,"us USA","DF",24,1993,31.6,57,33,39,14,4,26,54,48.1,28,37,7,30,44,101,114,0,"Matches","https://fbref.com/en/comps/9/2017-2018/defense/2017-2018-Premier-League-Stats"
"Maya Yoshida","Southampton",2018,"jp JPN","DF",28,1988,22.8,27,20,22,5,0,18,25,72,7,32,14,18,41,68,133,2,"Matches","https://fbref.com/en/comps/9/2017-2018/defense/2017-2018-Premier-League-Stats"
"Ashley Young","Manchester Utd",2018,"eng ENG","DF",32,1985,27.1,53,32,30,17,6,18,47,38.3,29,24,5,19,57,110,86,1,"Matches","https://fbref.com/en/comps/9/2017-2018/defense/2017-2018-Premier-League-Stats"
"Pablo Zabaleta","West Ham",2018,"ar ARG","DF,MF",32,1985,36.5,96,67,54,28,14,48,98,49,50,72,13,59,61,157,152,0,"Matches","https://fbref.com/en/comps/9/2017-2018/defense/2017-2018-Premier-League-Stats"
"Wilfried Zaha","Crystal Palace",2018,"ci CIV","FW,MF",24,1992,28.3,30,23,9,13,8,4,23,17.4,19,24,0,24,7,37,4,0,"Matches","https://fbref.com/en/comps/9/2017-2018/defense/2017-2018-Premier-League-Stats"
"Davide Zappacosta","Chelsea",2018,"it ITA","DF,MF",25,1992,12.2,26,11,14,9,3,11,25,44,14,11,2,9,6,32,26,0,"Matches","https://fbref.com/en/comps/9/2017-2018/defense/2017-2018-Premier-League-Stats"
"Marvin Zeegelaar","Watford",2018,"nl NED","DF",26,1990,11,23,18,15,3,5,11,24,45.8,13,5,1,4,20,43,30,0,"Matches","https://fbref.com/en/comps/9/2017-2018/defense/2017-2018-Premier-League-Stats"
"Oleksandr Zinchenko","Manchester City",2018,"ua UKR","DF",20,1996,5.9,23,16,11,9,3,7,13,53.8,6,3,0,3,6,29,7,0,"Matches","https://fbref.com/en/comps/9/2017-2018/defense/2017-2018-Premier-League-Stats"
"Kurt Zouma","Stoke City",2018,"fr FRA","DF",22,1994,32.1,50,38,35,13,2,21,28,75,7,42,23,19,61,111,246,2,"Matches","https://fbref.com/en/comps/9/2017-2018/defense/2017-2018-Premier-League-Stats"
