"Player","Squad","Season","Nation","Pos","Age","Born","Mins_Per_90","Tkl_Tackles","TklW_Tackles","Def 3rd_Tackles","Mid 3rd_Tackles","Att 3rd_Tackles","Tkl_Challenges","Att_Challenges","Tkl_percent_Challenges","Lost_Challenges","Blocks_Blocks","Sh_Blocks","Pass_Blocks","Int","Tkl+Int","Clr","Err","Matches","url"
"Brenden Aaronson","Leeds United",2023,"us USA","MF,FW",21,2000,26.4,45,18,16,22,7,15,46,32.6,31,43,3,40,5,50,6,1,"Matches","https://fbref.com/en/comps/9/defense/Premier-League-Stats"
"George Abbott","Tottenham",2023,"eng ENG","MF",16,2005,0,0,0,0,0,0,0,0,NA,0,0,0,0,1,1,0,0,"Matches","https://fbref.com/en/comps/9/defense/Premier-League-Stats"
"Che Adams","Southampton",2023,"sct SCO","FW",26,1996,22.1,17,13,7,8,2,7,12,58.3,5,13,4,9,4,21,22,0,"Matches","https://fbref.com/en/comps/9/defense/Premier-League-Stats"
"Tyler Adams","Leeds United",2023,"us USA","MF",23,1999,24,89,46,44,35,10,50,77,64.9,27,48,8,40,35,124,29,0,"Matches","https://fbref.com/en/comps/9/defense/Premier-League-Stats"
"Tosin Adarabioyo","Fulham",2023,"eng ENG","DF",24,1997,23.2,30,13,22,6,2,16,23,69.6,7,20,15,5,26,56,140,1,"Matches","https://fbref.com/en/comps/9/defense/Premier-League-Stats"
"Nayef Aguerd","West Ham",2023,"ma MAR","DF",26,1996,17.7,27,18,18,8,1,13,20,65,7,26,24,2,18,45,79,2,"Matches","https://fbref.com/en/comps/9/defense/Premier-League-Stats"
"Naouirou Ahamada","Crystal Palace",2023,"fr FRA","MF,FW",20,2002,1,3,2,3,0,0,1,3,33.3,2,2,0,2,0,3,0,0,"Matches","https://fbref.com/en/comps/9/defense/Premier-League-Stats"
"Rayan Aït Nouri","Wolves",2023,"dz ALG","DF",21,2001,12,33,20,25,7,1,9,15,60,6,3,0,3,9,42,28,0,"Matches","https://fbref.com/en/comps/9/defense/Premier-League-Stats"
"Kristoffer Ajer","Brentford",2023,"no NOR","DF",24,1998,8.5,11,8,5,4,2,9,16,56.3,7,6,5,1,7,18,22,0,"Matches","https://fbref.com/en/comps/9/defense/Premier-League-Stats"
"Manuel Akanji","Manchester City",2023,"ch SUI","DF",27,1995,25.4,36,25,15,18,3,23,36,63.9,13,27,9,18,16,52,33,0,"Matches","https://fbref.com/en/comps/9/defense/Premier-League-Stats"
"Nathan Aké","Manchester City",2023,"nl NED","DF",27,1995,20.8,26,12,15,9,2,11,15,73.3,4,20,10,10,20,46,48,0,"Matches","https://fbref.com/en/comps/9/defense/Premier-League-Stats"
"Marc Albrighton","Leicester City",2023,"eng ENG","FW,MF",32,1989,2.6,4,1,0,2,2,1,8,12.5,7,6,2,4,1,5,5,0,"Matches","https://fbref.com/en/comps/9/defense/Premier-League-Stats"
"Thiago Alcántara","Liverpool",2023,"es ESP","MF",31,1991,13.9,43,24,20,21,2,14,23,60.9,9,15,3,12,21,64,13,2,"Matches","https://fbref.com/en/comps/9/defense/Premier-League-Stats"
"Carlos Alcaraz","Southampton",2023,"ar ARG","MF,FW",19,2002,11.4,10,5,2,7,1,6,22,27.3,16,14,5,9,1,11,11,0,"Matches","https://fbref.com/en/comps/9/defense/Premier-League-Stats"
"Trent Alexander-Arnold","Liverpool",2023,"eng ENG","DF",23,1998,32.5,57,40,32,16,9,42,79,53.2,37,25,7,18,43,100,41,2,"Matches","https://fbref.com/en/comps/9/defense/Premier-League-Stats"
"Alisson","Liverpool",2023,"br BRA","GK",29,1992,37,0,0,0,0,0,0,3,0,3,3,0,3,0,0,20,0,"Matches","https://fbref.com/en/comps/9/defense/Premier-League-Stats"
"Dele Alli","Everton",2023,"eng ENG","MF",26,1996,0.4,0,0,0,0,0,0,0,NA,0,0,0,0,0,0,0,0,"Matches","https://fbref.com/en/comps/9/defense/Premier-League-Stats"
"Miguel Almirón","Newcastle Utd",2023,"py PAR","FW",28,1994,27.7,46,30,16,19,11,18,42,42.9,24,25,2,23,10,56,17,0,"Matches","https://fbref.com/en/comps/9/defense/Premier-League-Stats"
"Julián Álvarez","Manchester City",2023,"ar ARG","FW,MF",22,2000,16.3,26,16,3,13,10,9,29,31,20,13,0,13,2,28,6,0,"Matches","https://fbref.com/en/comps/9/defense/Premier-League-Stats"
"Daniel Amartey","Leicester City",2023,"gh GHA","DF",27,1994,17.9,19,8,13,5,1,12,14,85.7,2,24,17,7,8,27,71,0,"Matches","https://fbref.com/en/comps/9/defense/Premier-League-Stats"
"Samuel Amo-Ameyaw","Southampton",2023,"eng ENG","MF",16,2006,0,0,0,0,0,0,0,1,0,1,0,0,0,0,0,0,0,"Matches","https://fbref.com/en/comps/9/defense/Premier-League-Stats"
"Joachim Andersen","Crystal Palace",2023,"dk DEN","DF",26,1996,30.9,42,22,30,12,0,16,32,50,16,28,13,15,24,66,188,0,"Matches","https://fbref.com/en/comps/9/defense/Premier-League-Stats"
"Elliot Anderson","Newcastle Utd",2023,"sct SCO","MF,FW",19,2002,4.6,11,5,5,3,3,6,12,50,6,11,2,9,6,17,2,0,"Matches","https://fbref.com/en/comps/9/defense/Premier-League-Stats"
"Jaidon Anthony","Bournemouth",2023,"eng ENG","MF,FW",22,1999,14,30,17,15,9,6,8,24,33.3,16,30,3,27,10,40,19,0,"Matches","https://fbref.com/en/comps/9/defense/Premier-League-Stats"
"Michail Antonio","West Ham",2023,"jm JAM","FW",32,1990,20.3,14,7,1,8,5,3,12,25,9,13,5,8,5,19,9,0,"Matches","https://fbref.com/en/comps/9/defense/Premier-League-Stats"
"Antony","Manchester Utd",2023,"br BRA","FW",22,2000,20,22,9,9,9,4,8,28,28.6,20,18,0,18,11,33,6,0,"Matches","https://fbref.com/en/comps/9/defense/Premier-League-Stats"
"Cameron Archer","Aston Villa",2023,"eng ENG","FW,MF",21,2001,0.5,0,0,0,0,0,0,0,NA,0,0,0,0,0,0,0,0,"Matches","https://fbref.com/en/comps/9/defense/Premier-League-Stats"
"Alphonse Areola","West Ham",2023,"fr FRA","GK",29,1993,3.4,0,0,0,0,0,0,0,NA,0,0,0,0,0,0,0,0,"Matches","https://fbref.com/en/comps/9/defense/Premier-League-Stats"
"Joe Aribo","Southampton",2023,"ng NGA","MF,FW",26,1996,13.6,31,20,15,12,4,11,20,55,9,14,1,13,10,41,11,0,"Matches","https://fbref.com/en/comps/9/defense/Premier-League-Stats"
"Adam Armstrong","Southampton",2023,"eng ENG","FW,MF",25,1997,14.8,14,9,6,5,3,3,10,30,7,15,3,12,5,19,6,0,"Matches","https://fbref.com/en/comps/9/defense/Premier-League-Stats"
"Stuart Armstrong","Southampton",2023,"sct SCO","MF,FW",30,1992,15.6,32,21,15,13,4,14,39,35.9,25,18,0,18,10,42,9,1,"Matches","https://fbref.com/en/comps/9/defense/Premier-League-Stats"
"Kepa Arrizabalaga","Chelsea",2023,"es ESP","GK",27,1994,28.5,2,2,2,0,0,2,3,66.7,1,0,0,0,1,3,16,2,"Matches","https://fbref.com/en/comps/9/defense/Premier-League-Stats"
"Pierre-Emerick Aubameyang","Chelsea",2023,"ga GAB","FW",33,1989,6.2,1,0,1,0,0,0,1,0,1,2,0,2,2,3,4,2,"Matches","https://fbref.com/en/comps/9/defense/Premier-League-Stats"
"Ludwig Augustinsson","Aston Villa",2023,"se SWE","DF",28,1994,0.9,1,1,1,0,0,0,0,NA,0,0,0,0,0,1,1,0,"Matches","https://fbref.com/en/comps/9/defense/Premier-League-Stats"
"Serge Aurier","Nott'ham Forest",2023,"ci CIV","DF",29,1992,21.6,64,41,41,18,5,23,33,69.7,10,34,11,23,29,93,75,0,"Matches","https://fbref.com/en/comps/9/defense/Premier-League-Stats"
"Taiwo Awoniyi","Nott'ham Forest",2023,"ng NGA","FW",24,1997,15.6,17,10,2,10,5,6,10,60,4,18,4,14,4,21,20,0,"Matches","https://fbref.com/en/comps/9/defense/Premier-League-Stats"
"Yasin Ayari","Brighton",2023,"se SWE","MF",18,2003,0.7,2,2,1,1,0,0,4,0,4,1,0,1,0,2,0,0,"Matches","https://fbref.com/en/comps/9/defense/Premier-League-Stats"
"André Ayew","Nott'ham Forest",2023,"gh GHA","FW,MF",32,1989,3.5,5,3,0,4,1,2,4,50,2,6,1,5,0,5,7,0,"Matches","https://fbref.com/en/comps/9/defense/Premier-League-Stats"
"Jordan Ayew","Crystal Palace",2023,"gh GHA","FW,MF",30,1991,30.2,66,41,23,20,23,21,53,39.6,32,35,4,31,15,81,31,0,"Matches","https://fbref.com/en/comps/9/defense/Premier-League-Stats"
"Luke Ayling","Leeds United",2023,"eng ENG","DF",30,1991,22.8,66,37,42,15,9,42,85,49.4,43,34,11,23,26,92,52,2,"Matches","https://fbref.com/en/comps/9/defense/Premier-League-Stats"
"César Azpilicueta","Chelsea",2023,"es ESP","DF",32,1989,17,43,25,23,15,5,22,37,59.5,15,26,5,21,19,62,54,1,"Matches","https://fbref.com/en/comps/9/defense/Premier-League-Stats"
"Benoît Badiashile","Chelsea",2023,"fr FRA","DF",21,2001,10.1,14,8,10,4,0,9,14,64.3,5,5,2,3,16,30,34,1,"Matches","https://fbref.com/en/comps/9/defense/Premier-League-Stats"
"Leon Bailey","Aston Villa",2023,"jm JAM","FW,MF",24,1997,21.9,14,6,6,7,1,5,20,25,15,13,0,13,6,20,12,0,"Matches","https://fbref.com/en/comps/9/defense/Premier-League-Stats"
"Stefan Bajcetic","Liverpool",2023,"es ESP","MF",17,2004,5.8,9,6,5,3,1,8,27,29.6,19,7,0,7,9,18,4,0,"Matches","https://fbref.com/en/comps/9/defense/Premier-League-Stats"
"Dominic Ballard","Southampton",2023,"eng ENG","FW,MF",17,2005,0.3,0,0,0,0,0,0,0,NA,0,0,0,0,1,1,0,0,"Matches","https://fbref.com/en/comps/9/defense/Premier-League-Stats"
"Patrick Bamford","Leeds United",2023,"eng ENG","FW",28,1993,16.8,9,6,0,6,3,4,20,20,16,12,5,7,5,14,13,0,"Matches","https://fbref.com/en/comps/9/defense/Premier-League-Stats"
"Shandon Baptiste","Brentford",2023,"gd GRN","MF",24,1998,6.9,15,9,6,6,3,7,17,41.2,10,10,2,8,7,22,10,0,"Matches","https://fbref.com/en/comps/9/defense/Premier-League-Stats"
"Harvey Barnes","Leicester City",2023,"eng ENG","FW,MF",24,1997,30.1,26,14,8,14,4,14,42,33.3,28,32,1,31,8,34,12,0,"Matches","https://fbref.com/en/comps/9/defense/Premier-League-Stats"
"Gavin Bazunu","Southampton",2023,"ie IRL","GK",20,2002,32,1,0,1,0,0,1,1,100,0,0,0,0,1,2,24,2,"Matches","https://fbref.com/en/comps/9/defense/Premier-League-Stats"
"Mads Bech Sørensen","Brentford",2023,"dk DEN","DF,MF",23,1999,0.2,0,0,0,0,0,0,0,NA,0,0,0,0,1,1,1,0,"Matches","https://fbref.com/en/comps/9/defense/Premier-League-Stats"
"Jan Bednarek","Southampton",2023,"pl POL","DF",26,1996,18.6,27,21,20,7,0,12,16,75,4,38,27,11,49,76,87,0,"Matches","https://fbref.com/en/comps/9/defense/Premier-League-Stats"
"Jan Bednarek","Aston Villa",2023,"pl POL","DF",26,1996,1.1,3,3,0,3,0,1,1,100,0,3,1,2,2,5,5,0,"Matches","https://fbref.com/en/comps/9/defense/Premier-League-Stats"
"Donny van de Beek","Manchester Utd",2023,"nl NED","MF",25,1997,1.9,0,0,0,0,0,0,1,0,1,2,1,1,1,1,1,0,"Matches","https://fbref.com/en/comps/9/defense/Premier-League-Stats"
"Asmir Begovic","Everton",2023,"ba BIH","GK",35,1987,1,0,0,0,0,0,0,0,NA,0,0,0,0,0,0,1,0,"Matches","https://fbref.com/en/comps/9/defense/Premier-League-Stats"
"Armel Bella Kotchap","Southampton",2023,"de GER","DF",20,2001,20.9,37,17,28,9,0,15,20,75,5,29,12,17,44,81,110,0,"Matches","https://fbref.com/en/comps/9/defense/Premier-League-Stats"
"Saïd Benrahma","West Ham",2023,"dz ALG","FW,MF",26,1995,23,25,15,11,7,7,11,27,40.7,16,23,1,22,9,34,13,0,"Matches","https://fbref.com/en/comps/9/defense/Premier-League-Stats"
"Rodrigo Bentancur","Tottenham",2023,"uy URU","MF",25,1997,16.7,45,28,15,21,9,16,28,57.1,12,28,15,13,20,65,22,0,"Matches","https://fbref.com/en/comps/9/defense/Premier-League-Stats"
"Daniel Bentley","Wolves",2023,"eng ENG","GK",29,1993,2,1,1,1,0,0,1,1,100,0,0,0,0,0,1,0,0,"Matches","https://fbref.com/en/comps/9/defense/Premier-League-Stats"
"Victor Bernth Kristiansen","Leicester City",2023,"dk DEN","DF",19,2002,9.9,38,23,18,16,4,22,30,73.3,8,16,4,12,3,41,26,0,"Matches","https://fbref.com/en/comps/9/defense/Premier-League-Stats"
"Owen Bevan","Bournemouth",2023,"wls WAL","DF",18,2003,0.1,0,0,0,0,0,0,0,NA,0,0,0,0,0,0,0,0,"Matches","https://fbref.com/en/comps/9/defense/Premier-League-Stats"
"Giulian Biancone","Nott'ham Forest",2023,"fr FRA","DF",22,2000,0.2,2,1,2,0,0,1,1,100,0,0,0,0,1,3,0,0,"Matches","https://fbref.com/en/comps/9/defense/Premier-League-Stats"
"Philip Billing","Bournemouth",2023,"dk DEN","MF,FW",26,1996,30.7,63,36,21,33,9,11,40,27.5,29,48,8,40,31,94,58,1,"Matches","https://fbref.com/en/comps/9/defense/Premier-League-Stats"
"Yves Bissouma","Tottenham",2023,"ml MLI","MF",25,1996,11.2,16,13,6,6,4,2,7,28.6,5,15,6,9,12,28,10,0,"Matches","https://fbref.com/en/comps/9/defense/Premier-League-Stats"
"Willy Boly","Nott'ham Forest",2023,"ci CIV","DF",31,1991,7.6,13,6,8,3,2,8,13,61.5,5,13,4,9,12,25,45,0,"Matches","https://fbref.com/en/comps/9/defense/Premier-League-Stats"
"Sven Botman","Newcastle Utd",2023,"nl NED","DF",22,2000,34.7,38,24,31,7,0,22,28,78.6,6,44,24,20,34,72,126,2,"Matches","https://fbref.com/en/comps/9/defense/Premier-League-Stats"
"Jarrod Bowen","West Ham",2023,"eng ENG","FW,MF",25,1996,35.9,39,16,14,11,14,16,57,28.1,41,47,9,38,36,75,25,0,"Matches","https://fbref.com/en/comps/9/defense/Premier-League-Stats"
"James Bree","Southampton",2023,"eng ENG","DF",24,1997,4.1,5,3,4,1,0,3,4,75,1,3,1,2,6,11,11,0,"Matches","https://fbref.com/en/comps/9/defense/Premier-League-Stats"
"Armando Broja","Chelsea",2023,"al ALB","FW",20,2001,3.3,4,1,0,3,1,1,1,100,0,10,1,9,1,5,1,0,"Matches","https://fbref.com/en/comps/9/defense/Premier-League-Stats"
"David Brooks","Bournemouth",2023,"wls WAL","FW,MF",25,1997,1.9,1,0,1,0,0,0,1,0,1,2,0,2,2,3,5,0,"Matches","https://fbref.com/en/comps/9/defense/Premier-League-Stats"
"Lewis Brunt","Leicester City",2023,"eng ENG","DF",21,2000,0.3,0,0,0,0,0,0,0,NA,0,0,0,0,0,0,2,0,"Matches","https://fbref.com/en/comps/9/defense/Premier-League-Stats"
"Bryan","Tottenham",2023,"es ESP","MF,FW",21,2001,1.6,3,1,3,0,0,0,3,0,3,3,0,3,1,4,1,0,"Matches","https://fbref.com/en/comps/9/defense/Premier-League-Stats"
"Emi Buendía","Aston Villa",2023,"ar ARG","MF,FW",25,1996,26.8,52,23,20,20,12,21,74,28.4,53,20,2,18,20,72,17,0,"Matches","https://fbref.com/en/comps/9/defense/Premier-League-Stats"
"Hugo Bueno","Wolves",2023,"es ESP","DF",19,2002,14.6,33,16,23,6,4,17,33,51.5,16,14,1,13,10,43,36,0,"Matches","https://fbref.com/en/comps/9/defense/Premier-League-Stats"
"Facundo Buonanotte","Brighton",2023,"ar ARG","FW,MF",17,2004,6.3,2,1,1,1,0,1,22,4.5,21,5,2,3,4,6,3,0,"Matches","https://fbref.com/en/comps/9/defense/Premier-League-Stats"
"Dan Burn","Newcastle Utd",2023,"eng ENG","DF",30,1992,34.6,60,38,29,23,8,34,67,50.7,33,42,16,26,32,92,120,2,"Matches","https://fbref.com/en/comps/9/defense/Premier-League-Stats"
"Cafú","Nott'ham Forest",2023,"pt POR","MF",29,1993,0.1,0,0,0,0,0,0,0,NA,0,0,0,0,0,0,1,0,"Matches","https://fbref.com/en/comps/9/defense/Premier-League-Stats"
"Moisés Caicedo","Brighton",2023,"ec ECU","MF",20,2001,34.9,100,50,41,47,12,40,68,58.8,28,43,7,36,56,156,31,3,"Matches","https://fbref.com/en/comps/9/defense/Premier-League-Stats"
"Tom Cairney","Fulham",2023,"sct SCO","MF",31,1991,11,17,6,4,8,5,7,10,70,3,18,3,15,5,22,3,0,"Matches","https://fbref.com/en/comps/9/defense/Premier-League-Stats"
"Duje Caleta-Car","Southampton",2023,"hr CRO","DF",25,1996,10.5,14,10,9,4,1,6,9,66.7,3,15,11,4,15,29,65,1,"Matches","https://fbref.com/en/comps/9/defense/Premier-League-Stats"
"Dominic Calvert-Lewin","Everton",2023,"eng ENG","FW",25,1997,12.9,4,2,1,0,3,1,5,20,4,5,1,4,3,7,18,0,"Matches","https://fbref.com/en/comps/9/defense/Premier-League-Stats"
"Chem Campbell","Wolves",2023,"wls WAL","FW,MF",19,2002,0.8,2,1,1,1,0,0,1,0,1,2,0,2,1,3,0,0,"Matches","https://fbref.com/en/comps/9/defense/Premier-League-Stats"
"João Cancelo","Manchester City",2023,"pt POR","DF",28,1994,14.2,29,21,16,9,4,17,24,70.8,7,7,1,6,19,48,9,1,"Matches","https://fbref.com/en/comps/9/defense/Premier-League-Stats"
"Thomas Cannon","Everton",2023,"ie IRL","FW",19,2002,0.3,0,0,0,0,0,0,0,NA,0,0,0,0,0,0,0,0,"Matches","https://fbref.com/en/comps/9/defense/Premier-League-Stats"
"Sergi Canós","Brentford",2023,"es ESP","FW,DF",25,1997,0.9,0,0,0,0,0,0,2,0,2,3,1,2,0,0,1,0,"Matches","https://fbref.com/en/comps/9/defense/Premier-League-Stats"
"Diego Carlos","Aston Villa",2023,"br BRA","DF",29,1993,2.3,1,0,0,1,0,0,1,0,1,2,2,0,1,2,2,0,"Matches","https://fbref.com/en/comps/9/defense/Premier-League-Stats"
"Fabio Carvalho","Liverpool",2023,"pt POR","MF,FW",19,2002,3.9,8,8,3,3,2,3,6,50,3,6,0,6,6,14,0,0,"Matches","https://fbref.com/en/comps/9/defense/Premier-League-Stats"
"Casemiro","Manchester Utd",2023,"br BRA","MF",30,1992,23.6,89,46,43,35,11,48,92,52.2,44,49,11,38,34,123,64,0,"Matches","https://fbref.com/en/comps/9/defense/Premier-League-Stats"
"Matty Cash","Aston Villa",2023,"pl POL","DF",24,1997,20.2,55,32,36,15,4,26,37,70.3,11,20,5,15,26,81,43,0,"Matches","https://fbref.com/en/comps/9/defense/Premier-League-Stats"
"Timothy Castagne","Leicester City",2023,"be BEL","DF",26,1995,36.2,87,44,53,27,7,41,84,48.8,43,50,13,37,43,130,110,0,"Matches","https://fbref.com/en/comps/9/defense/Premier-League-Stats"
"Jonny Castro","Wolves",2023,"es ESP","DF",28,1994,14,34,15,23,10,1,18,37,48.6,19,26,5,21,14,48,28,2,"Matches","https://fbref.com/en/comps/9/defense/Premier-League-Stats"
"Julio César Enciso","Brighton",2023,"py PAR","FW,MF",18,2004,9,13,4,3,6,4,8,13,61.5,5,9,0,9,4,17,2,0,"Matches","https://fbref.com/en/comps/9/defense/Premier-League-Stats"
"Nathaniel Chalobah","Fulham",2023,"eng ENG","MF",27,1994,0.1,1,1,1,0,0,1,1,100,0,0,0,0,0,1,2,0,"Matches","https://fbref.com/en/comps/9/defense/Premier-League-Stats"
"Trevoh Chalobah","Chelsea",2023,"eng ENG","DF",23,1999,17.9,31,20,22,6,3,24,34,70.6,10,17,7,10,24,55,56,1,"Matches","https://fbref.com/en/comps/9/defense/Premier-League-Stats"
"Calum Chambers","Aston Villa",2023,"eng ENG","DF,MF",27,1995,3.9,9,6,7,2,0,6,8,75,2,5,4,1,7,16,10,1,"Matches","https://fbref.com/en/comps/9/defense/Premier-League-Stats"
"Shea Charles","Manchester City",2023,"nir NIR","DF",18,2003,0.3,4,0,4,0,0,1,1,100,0,0,0,0,1,5,2,0,"Matches","https://fbref.com/en/comps/9/defense/Premier-League-Stats"
"Ben Chilwell","Chelsea",2023,"eng ENG","DF,MF",25,1996,15.6,21,17,12,8,1,13,25,52,12,21,2,19,18,39,26,0,"Matches","https://fbref.com/en/comps/9/defense/Premier-League-Stats"
"Ryan Christie","Bournemouth",2023,"sct SCO","MF,FW",27,1995,20.4,34,22,10,23,1,14,49,28.6,35,16,4,12,26,60,20,0,"Matches","https://fbref.com/en/comps/9/defense/Premier-League-Stats"
"Carney Chukwuemeka","Chelsea",2023,"eng ENG","MF,FW",18,2003,3.9,13,7,7,6,0,3,5,60,2,7,0,7,6,19,1,0,"Matches","https://fbref.com/en/comps/9/defense/Premier-League-Stats"
"Bobby Clark","Liverpool",2023,"eng ENG","MF",17,2005,0.1,0,0,0,0,0,0,0,NA,0,2,0,2,0,0,0,0,"Matches","https://fbref.com/en/comps/9/defense/Premier-League-Stats"
"Nathaniel Clyne","Crystal Palace",2023,"eng ENG","DF",31,1991,18.2,27,16,13,9,5,14,23,60.9,9,22,4,18,19,46,34,0,"Matches","https://fbref.com/en/comps/9/defense/Premier-League-Stats"
"Conor Coady","Everton",2023,"eng ENG","DF",29,1993,23.3,14,9,8,6,0,7,15,46.7,8,21,17,4,14,28,88,3,"Matches","https://fbref.com/en/comps/9/defense/Premier-League-Stats"
"Jack Colback","Nott'ham Forest",2023,"eng ENG","MF",32,1989,5.5,18,13,12,6,0,5,8,62.5,3,3,0,3,3,21,9,0,"Matches","https://fbref.com/en/comps/9/defense/Premier-League-Stats"
"Séamus Coleman","Everton",2023,"ie IRL","DF",33,1988,18.4,35,26,21,10,4,19,29,65.5,10,14,7,7,22,57,58,2,"Matches","https://fbref.com/en/comps/9/defense/Premier-League-Stats"
"Nathan Collins","Wolves",2023,"ie IRL","DF",21,2001,20.2,27,15,19,8,0,15,24,62.5,9,35,28,7,21,48,84,0,"Matches","https://fbref.com/en/comps/9/defense/Premier-League-Stats"
"Levi Colwill","Brighton",2023,"eng ENG","DF",19,2003,13.6,8,7,4,4,0,4,9,44.4,5,5,3,2,15,23,37,1,"Matches","https://fbref.com/en/comps/9/defense/Premier-League-Stats"
"Lewis Cook","Bournemouth",2023,"eng ENG","MF",25,1997,19.1,37,22,10,22,5,18,42,42.9,24,29,10,19,23,60,31,0,"Matches","https://fbref.com/en/comps/9/defense/Premier-League-Stats"
"Steve Cook","Nott'ham Forest",2023,"eng ENG","DF",31,1991,10.6,8,4,4,4,0,5,7,71.4,2,16,11,5,12,20,51,0,"Matches","https://fbref.com/en/comps/9/defense/Premier-League-Stats"
"Liam Cooper","Leeds United",2023,"sct SCO","DF",30,1991,15.8,38,23,27,9,2,23,36,63.9,13,16,8,8,34,72,57,3,"Matches","https://fbref.com/en/comps/9/defense/Premier-League-Stats"
"Maxwel Cornet","West Ham",2023,"ci CIV","FW",25,1996,2.7,7,3,5,0,2,4,6,66.7,2,6,0,6,2,9,3,0,"Matches","https://fbref.com/en/comps/9/defense/Premier-League-Stats"
"Diego Costa","Wolves",2023,"es ESP","FW",33,1988,13.8,3,1,3,0,0,2,9,22.2,7,6,1,5,2,5,17,0,"Matches","https://fbref.com/en/comps/9/defense/Premier-League-Stats"
"Vladimír Coufal","West Ham",2023,"cz CZE","DF",29,1992,23.7,58,31,37,15,6,36,51,70.6,15,24,6,18,38,96,70,0,"Matches","https://fbref.com/en/comps/9/defense/Premier-League-Stats"
"Philippe Coutinho","Aston Villa",2023,"br BRA","MF,FW",30,1992,8.8,19,14,8,8,3,9,15,60,6,11,1,10,4,23,2,0,"Matches","https://fbref.com/en/comps/9/defense/Premier-League-Stats"
"Conor Coventry","West Ham",2023,"ie IRL","MF,FW",22,2000,0,0,0,0,0,0,0,0,NA,0,0,0,0,0,0,0,0,"Matches","https://fbref.com/en/comps/9/defense/Premier-League-Stats"
"Matthew Craig","Tottenham",2023,"sct SCO","MF",19,2003,0.2,4,1,2,2,0,0,0,NA,0,0,0,0,0,4,0,0,"Matches","https://fbref.com/en/comps/9/defense/Premier-League-Stats"
"Aaron Cresswell","West Ham",2023,"eng ENG","DF",32,1989,24.8,21,11,12,7,2,12,31,38.7,19,21,11,10,27,48,56,0,"Matches","https://fbref.com/en/comps/9/defense/Premier-League-Stats"
"Marc Cucurella","Chelsea",2023,"es ESP","DF",24,1998,18.6,66,33,40,15,11,30,60,50,30,28,8,20,16,82,48,1,"Matches","https://fbref.com/en/comps/9/defense/Premier-League-Stats"
"Matheus Cunha","Wolves",2023,"br BRA","FW",23,1999,10.7,7,4,0,5,2,2,10,20,8,15,3,12,9,16,11,0,"Matches","https://fbref.com/en/comps/9/defense/Premier-League-Stats"
"Patson Daka","Leicester City",2023,"zm ZAM","FW",23,1998,13.2,14,8,6,8,0,3,12,25,9,14,2,12,7,21,7,0,"Matches","https://fbref.com/en/comps/9/defense/Premier-League-Stats"
"Diogo Dalot","Manchester Utd",2023,"pt POR","DF",23,1999,23.9,54,41,40,13,1,33,45,73.3,12,25,7,18,37,91,55,2,"Matches","https://fbref.com/en/comps/9/defense/Premier-League-Stats"
"Mikkel Damsgaard","Brentford",2023,"dk DEN","MF,FW",22,2000,11,31,21,13,13,5,15,42,35.7,27,20,2,18,10,41,14,0,"Matches","https://fbref.com/en/comps/9/defense/Premier-League-Stats"
"Danilo","Nott'ham Forest",2023,"br BRA","MF",21,2001,10.8,18,7,7,9,2,6,25,24,19,26,6,20,9,27,19,0,"Matches","https://fbref.com/en/comps/9/defense/Premier-League-Stats"
"Arnaut Danjuma","Tottenham",2023,"nl NED","FW,MF",25,1997,1.9,2,0,1,1,0,0,0,NA,0,1,0,1,0,2,0,0,"Matches","https://fbref.com/en/comps/9/defense/Premier-League-Stats"
"Josh Dasilva","Brentford",2023,"eng ENG","MF",23,1998,15.4,18,9,6,6,6,6,16,37.5,10,22,6,16,5,23,7,1,"Matches","https://fbref.com/en/comps/9/defense/Premier-League-Stats"
"Ben Davies","Tottenham",2023,"wls WAL","DF",29,1993,25.4,28,11,13,13,2,14,26,53.8,12,17,8,9,18,46,72,0,"Matches","https://fbref.com/en/comps/9/defense/Premier-League-Stats"
"Tom Davies","Everton",2023,"eng ENG","MF",24,1998,6,15,9,5,9,1,7,14,50,7,10,1,9,4,19,7,1,"Matches","https://fbref.com/en/comps/9/defense/Premier-League-Stats"
"Craig Dawson","West Ham",2023,"eng ENG","DF",32,1990,8,10,6,8,2,0,4,6,66.7,2,9,6,3,6,16,26,0,"Matches","https://fbref.com/en/comps/9/defense/Premier-League-Stats"
"Craig Dawson","Wolves",2023,"eng ENG","DF",32,1990,15.7,9,6,6,3,0,4,7,57.1,3,31,23,8,12,21,74,2,"Matches","https://fbref.com/en/comps/9/defense/Premier-League-Stats"
"Kevin De Bruyne","Manchester City",2023,"be BEL","MF",31,1991,26.9,28,12,3,12,13,14,39,35.9,25,27,2,25,9,37,10,0,"Matches","https://fbref.com/en/comps/9/defense/Premier-League-Stats"
"Siriki Dembélé","Bournemouth",2023,"ci CIV","FW,MF",25,1996,1.2,3,1,2,1,0,0,1,0,1,1,0,1,1,4,1,0,"Matches","https://fbref.com/en/comps/9/defense/Premier-League-Stats"
"Leander Dendoncker","Aston Villa",2023,"be BEL","MF",27,1995,7.7,19,9,11,6,2,11,21,52.4,10,19,4,15,10,29,12,0,"Matches","https://fbref.com/en/comps/9/defense/Premier-League-Stats"
"Leander Dendoncker","Wolves",2023,"be BEL","MF",27,1995,2.4,4,2,0,3,1,2,3,66.7,1,2,0,2,9,13,4,0,"Matches","https://fbref.com/en/comps/9/defense/Premier-League-Stats"
"Emmanuel Dennis","Nott'ham Forest",2023,"ng NGA","FW,MF",24,1997,8,17,11,5,5,7,8,17,47.1,9,13,1,12,2,19,6,0,"Matches","https://fbref.com/en/comps/9/defense/Premier-League-Stats"
"Halil Dervisoglu","Brentford",2023,"tr TUR","MF",22,1999,0.1,0,0,0,0,0,0,1,0,1,0,0,0,0,0,0,0,"Matches","https://fbref.com/en/comps/9/defense/Premier-League-Stats"
"Kiernan Dewsbury-Hall","Leicester City",2023,"eng ENG","MF",23,1998,25.6,53,29,14,34,5,19,47,40.4,28,55,13,42,28,81,21,0,"Matches","https://fbref.com/en/comps/9/defense/Premier-League-Stats"
"Ibrahima Diallo","Southampton",2023,"fr FRA","MF",23,1999,9.1,25,15,14,10,1,8,14,57.1,6,11,1,10,6,31,11,0,"Matches","https://fbref.com/en/comps/9/defense/Premier-League-Stats"
"Rúben Dias","Manchester City",2023,"pt POR","DF",25,1997,22.2,21,13,10,10,1,11,18,61.1,7,21,13,8,18,39,56,1,"Matches","https://fbref.com/en/comps/9/defense/Premier-League-Stats"
"Luis Díaz","Liverpool",2023,"co COL","FW",25,1997,11.1,17,11,4,8,5,8,15,53.3,7,8,0,8,6,23,2,0,"Matches","https://fbref.com/en/comps/9/defense/Premier-League-Stats"
"Eric Dier","Tottenham",2023,"eng ENG","DF",28,1994,31.3,30,19,16,12,2,9,19,47.4,10,41,24,17,35,65,112,2,"Matches","https://fbref.com/en/comps/9/defense/Premier-League-Stats"
"Lucas Digne","Aston Villa",2023,"fr FRA","DF",29,1993,16.7,30,12,20,9,1,20,33,60.6,13,18,5,13,18,48,45,0,"Matches","https://fbref.com/en/comps/9/defense/Premier-League-Stats"
"Issa Diop","Fulham",2023,"fr FRA","DF",25,1997,22.4,28,19,18,9,1,17,32,53.1,15,24,17,7,35,63,86,0,"Matches","https://fbref.com/en/comps/9/defense/Premier-League-Stats"
"Moussa Djenepo","Southampton",2023,"ml MLI","DF,FW",24,1998,7.9,19,11,13,5,1,11,26,42.3,15,19,2,17,11,30,7,0,"Matches","https://fbref.com/en/comps/9/defense/Premier-League-Stats"
"Ben Doak","Liverpool",2023,"sct SCO","FW",16,2005,0.3,3,2,1,2,0,1,1,100,0,1,0,1,0,3,0,0,"Matches","https://fbref.com/en/comps/9/defense/Premier-League-Stats"
"Matt Doherty","Tottenham",2023,"ie IRL","DF,MF",30,1992,7.4,16,10,12,3,1,8,10,80,2,11,6,5,8,24,14,1,"Matches","https://fbref.com/en/comps/9/defense/Premier-League-Stats"
"Gabriel Dos Santos","Arsenal",2023,"br BRA","DF",24,1997,37.9,48,30,29,15,4,18,27,66.7,9,49,26,23,32,80,125,2,"Matches","https://fbref.com/en/comps/9/defense/Premier-League-Stats"
"Abdoulaye Doucouré","Everton",2023,"ml MLI","MF",29,1993,17,31,20,9,15,7,12,37,32.4,25,26,3,23,13,44,11,0,"Matches","https://fbref.com/en/comps/9/defense/Premier-League-Stats"
"Cheick Doucouré","Crystal Palace",2023,"ml MLI","MF",22,2000,30.8,77,46,40,33,4,29,52,55.8,23,47,13,34,56,133,48,0,"Matches","https://fbref.com/en/comps/9/defense/Premier-League-Stats"
"Flynn Downes","West Ham",2023,"eng ENG","MF",23,1999,8.5,16,9,4,10,2,6,12,50,6,15,2,13,7,23,6,0,"Matches","https://fbref.com/en/comps/9/defense/Premier-League-Stats"
"Kami Doyle","Southampton",2023,"eng ENG","MF",16,2005,0.1,0,0,0,0,0,0,0,NA,0,0,0,0,0,0,0,0,"Matches","https://fbref.com/en/comps/9/defense/Premier-League-Stats"
"Cody Drameh","Leeds United",2023,"eng ENG","DF",20,2001,0.8,5,4,0,4,1,2,3,66.7,1,0,0,0,1,6,1,0,"Matches","https://fbref.com/en/comps/9/defense/Premier-League-Stats"
"Martin Dúbravka","Newcastle Utd",2023,"sk SVK","GK",33,1989,1.7,0,0,0,0,0,0,1,0,1,0,0,0,0,0,1,0,"Matches","https://fbref.com/en/comps/9/defense/Premier-League-Stats"
"Shane Duffy","Fulham",2023,"ie IRL","DF,FW",30,1992,0.2,0,0,0,0,0,0,0,NA,0,0,0,0,0,0,0,1,"Matches","https://fbref.com/en/comps/9/defense/Premier-League-Stats"
"Lewis Dunk","Brighton",2023,"eng ENG","DF",30,1991,36,30,19,19,9,2,18,41,43.9,23,37,27,10,34,64,81,1,"Matches","https://fbref.com/en/comps/9/defense/Premier-League-Stats"
"Jhon Durán","Aston Villa",2023,"co COL","FW,MF",18,2003,1.5,2,2,0,1,1,1,4,25,3,0,0,0,2,4,2,0,"Matches","https://fbref.com/en/comps/9/defense/Premier-League-Stats"
"Malcolm Ebiowei","Crystal Palace",2023,"eng ENG","MF,FW",18,2003,0.4,1,1,1,0,0,0,1,0,1,2,0,2,0,1,0,0,"Matches","https://fbref.com/en/comps/9/defense/Premier-League-Stats"
"Ederson","Manchester City",2023,"br BRA","GK",28,1993,35,3,1,3,0,0,1,2,50,1,0,0,0,1,4,10,2,"Matches","https://fbref.com/en/comps/9/defense/Premier-League-Stats"
"Odsonne Édouard","Crystal Palace",2023,"fr FRA","FW",24,1998,20,25,13,7,12,6,7,13,53.8,6,17,5,12,3,28,22,0,"Matches","https://fbref.com/en/comps/9/defense/Premier-League-Stats"
"Samuel Edozie","Southampton",2023,"eng ENG","FW,MF",19,2003,6.3,17,10,6,10,1,3,8,37.5,5,7,0,7,6,23,6,0,"Matches","https://fbref.com/en/comps/9/defense/Premier-League-Stats"
"Anthony Elanga","Manchester Utd",2023,"se SWE","FW",20,2002,4.7,3,0,0,2,1,1,2,50,1,4,0,4,2,5,4,0,"Matches","https://fbref.com/en/comps/9/defense/Premier-League-Stats"
"Harvey Elliott","Liverpool",2023,"eng ENG","MF,FW",19,2003,17.9,27,18,6,12,9,9,36,25,27,26,1,25,15,42,8,0,"Matches","https://fbref.com/en/comps/9/defense/Premier-League-Stats"
"Mohamed Elneny","Arsenal",2023,"eg EGY","MF",30,1992,1.3,1,1,1,0,0,1,1,100,0,0,0,0,0,1,0,0,"Matches","https://fbref.com/en/comps/9/defense/Premier-League-Stats"
"Mohamed Elyounoussi","Southampton",2023,"no NOR","MF,FW",27,1994,24.1,46,28,22,20,4,19,43,44.2,24,40,3,37,27,73,37,0,"Matches","https://fbref.com/en/comps/9/defense/Premier-League-Stats"
"Emerson","Tottenham",2023,"br BRA","DF",23,1999,19.3,54,33,38,12,4,27,40,67.5,13,17,3,14,18,72,75,0,"Matches","https://fbref.com/en/comps/9/defense/Premier-League-Stats"
"Christian Eriksen","Manchester Utd",2023,"dk DEN","MF",30,1992,22.8,22,18,10,7,5,10,32,31.3,22,23,9,14,11,33,20,1,"Matches","https://fbref.com/en/comps/9/defense/Premier-League-Stats"
"Pervis Estupiñán","Brighton",2023,"ec ECU","DF",24,1998,29.7,61,31,36,19,6,35,60,58.3,25,30,8,22,37,98,37,1,"Matches","https://fbref.com/en/comps/9/defense/Premier-League-Stats"
"Jonny Evans","Leicester City",2023,"nir NIR","DF",34,1988,11.7,13,5,12,1,0,7,11,63.6,4,15,11,4,18,31,51,0,"Matches","https://fbref.com/en/comps/9/defense/Premier-League-Stats"
"Eberechi Eze","Crystal Palace",2023,"eng ENG","MF,FW",24,1998,29.3,42,24,17,18,7,18,38,47.4,20,22,0,22,13,55,10,0,"Matches","https://fbref.com/en/comps/9/defense/Premier-League-Stats"
"Lukasz Fabianski","West Ham",2023,"pl POL","GK",37,1985,34.6,2,0,2,0,0,1,2,50,1,1,0,1,0,2,10,1,"Matches","https://fbref.com/en/comps/9/defense/Premier-League-Stats"
"Fabinho","Liverpool",2023,"br BRA","MF",28,1993,29.7,65,38,18,40,7,24,62,38.7,38,38,11,27,37,102,40,0,"Matches","https://fbref.com/en/comps/9/defense/Premier-League-Stats"
"Wout Faes","Leicester City",2023,"be BEL","DF",24,1998,31,56,33,28,26,2,28,44,63.6,16,53,37,16,41,97,113,2,"Matches","https://fbref.com/en/comps/9/defense/Premier-League-Stats"
"Felipe","Nott'ham Forest",2023,"br BRA","DF",33,1989,15.8,42,23,29,13,0,24,41,58.5,17,34,13,21,36,78,90,0,"Matches","https://fbref.com/en/comps/9/defense/Premier-League-Stats"
"João Félix","Chelsea",2023,"pt POR","FW,MF",22,1999,10.5,14,7,5,6,3,4,12,33.3,8,3,0,3,1,15,1,1,"Matches","https://fbref.com/en/comps/9/defense/Premier-League-Stats"
"Evan Ferguson","Brighton",2023,"ie IRL","FW",17,2004,10.6,6,3,1,3,2,1,7,14.3,6,11,1,10,2,8,6,0,"Matches","https://fbref.com/en/comps/9/defense/Premier-League-Stats"
"Bruno Fernandes","Manchester Utd",2023,"pt POR","MF,FW",27,1994,36.8,68,42,24,25,19,30,71,42.3,41,37,5,32,25,93,40,1,"Matches","https://fbref.com/en/comps/9/defense/Premier-League-Stats"
"Enzo Fernández","Chelsea",2023,"ar ARG","MF",21,2001,17.2,45,27,25,17,3,21,56,37.5,35,32,2,30,16,61,12,1,"Matches","https://fbref.com/en/comps/9/defense/Premier-League-Stats"
"Roberto Firmino","Liverpool",2023,"br BRA","FW,MF",30,1991,13.5,17,12,2,12,3,4,21,19,17,16,1,15,7,24,2,0,"Matches","https://fbref.com/en/comps/9/defense/Premier-League-Stats"
"Junior Firpo","Leeds United",2023,"es ESP","DF",25,1996,15.2,47,25,27,15,5,24,46,52.2,22,23,7,16,24,71,40,0,"Matches","https://fbref.com/en/comps/9/defense/Premier-League-Stats"
"Phil Foden","Manchester City",2023,"eng ENG","FW",22,2000,20.5,16,10,9,5,2,8,19,42.1,11,25,2,23,5,21,12,0,"Matches","https://fbref.com/en/comps/9/defense/Premier-League-Stats"
"Datro Fofana","Chelsea",2023,"ci CIV","FW",19,2002,0.8,3,1,1,1,1,1,1,100,0,1,0,1,0,3,0,0,"Matches","https://fbref.com/en/comps/9/defense/Premier-League-Stats"
"Wesley Fofana","Leicester City",2023,"fr FRA","DF",21,2000,2,4,2,1,2,1,1,3,33.3,2,1,1,0,9,13,5,0,"Matches","https://fbref.com/en/comps/9/defense/Premier-League-Stats"
"Wesley Fofana","Chelsea",2023,"fr FRA","DF",21,2000,13.1,30,18,19,7,4,13,26,50,13,17,10,7,20,50,33,2,"Matches","https://fbref.com/en/comps/9/defense/Premier-League-Stats"
"Pablo Fornals","West Ham",2023,"es ESP","FW,MF",26,1996,16.7,30,15,9,12,9,13,34,38.2,21,16,2,14,14,44,9,0,"Matches","https://fbref.com/en/comps/9/defense/Premier-League-Stats"
"Adam Forshaw","Leeds United",2023,"eng ENG","MF",30,1991,5.3,12,9,5,7,0,7,17,41.2,10,9,1,8,4,16,2,0,"Matches","https://fbref.com/en/comps/9/defense/Premier-League-Stats"
"Fraser Forster","Tottenham",2023,"eng ENG","GK",34,1988,13.5,1,0,1,0,0,0,0,NA,0,1,0,1,0,1,3,1,"Matches","https://fbref.com/en/comps/9/defense/Premier-League-Stats"
"Tyrese Francois","Fulham",2023,"au AUS","FW",22,2000,0,0,0,0,0,0,0,0,NA,0,0,0,0,0,0,1,0,"Matches","https://fbref.com/en/comps/9/defense/Premier-League-Stats"
"Ryan Fraser","Newcastle Utd",2023,"sct SCO","FW",28,1994,3.5,2,2,0,0,2,2,5,40,3,3,1,2,0,2,3,0,"Matches","https://fbref.com/en/comps/9/defense/Premier-League-Stats"
"Fred","Manchester Utd",2023,"br BRA","MF",29,1993,13.9,47,30,24,20,3,15,38,39.5,23,38,2,36,19,66,19,0,"Matches","https://fbref.com/en/comps/9/defense/Premier-League-Stats"
"Ryan Fredericks","Bournemouth",2023,"eng ENG","DF",29,1992,5.9,3,2,2,0,1,1,4,25,3,7,2,5,1,4,27,0,"Matches","https://fbref.com/en/comps/9/defense/Premier-League-Stats"
"Remo Freuler","Nott'ham Forest",2023,"ch SUI","MF",30,1992,24,43,23,23,15,5,19,43,44.2,24,36,9,27,29,72,45,0,"Matches","https://fbref.com/en/comps/9/defense/Premier-League-Stats"
"Cody Gakpo","Liverpool",2023,"nl NED","FW,MF",23,1999,16.2,26,15,4,13,9,13,38,34.2,25,13,1,12,4,30,2,0,"Matches","https://fbref.com/en/comps/9/defense/Premier-League-Stats"
"Conor Gallagher","Chelsea",2023,"eng ENG","MF",22,2000,18,46,33,17,19,10,10,37,27,27,41,10,31,23,69,18,1,"Matches","https://fbref.com/en/comps/9/defense/Premier-League-Stats"
"Idrissa Gana Gueye","Everton",2023,"sn SEN","MF",32,1989,28.6,97,57,49,35,13,31,60,51.7,29,50,12,38,56,153,34,3,"Matches","https://fbref.com/en/comps/9/defense/Premier-League-Stats"
"Alejandro Garnacho","Manchester Utd",2023,"ar ARG","FW,MF",18,2004,6.3,5,2,2,0,3,1,11,9.1,10,5,0,5,5,10,3,0,"Matches","https://fbref.com/en/comps/9/defense/Premier-League-Stats"
"James Garner","Everton",2023,"eng ENG","MF,DF",21,2001,8.9,16,13,4,8,4,9,19,47.4,10,9,1,8,12,28,13,0,"Matches","https://fbref.com/en/comps/9/defense/Premier-League-Stats"
"David de Gea","Manchester Utd",2023,"es ESP","GK",31,1990,38,0,0,0,0,0,0,1,0,1,0,0,0,1,1,15,3,"Matches","https://fbref.com/en/comps/9/defense/Premier-League-Stats"
"Joe Gelhardt","Leeds United",2023,"eng ENG","FW",20,2002,2.4,6,2,1,3,2,3,5,60,2,5,0,5,0,6,4,0,"Matches","https://fbref.com/en/comps/9/defense/Premier-League-Stats"
"Saman Ghoddos","Brentford",2023,"ir IRN","MF,FW",28,1993,1.5,2,1,0,1,1,1,3,33.3,2,5,1,4,4,6,2,0,"Matches","https://fbref.com/en/comps/9/defense/Premier-League-Stats"
"Morgan Gibbs-White","Wolves",2023,"eng ENG","FW,MF",22,2000,2,3,1,3,0,0,2,3,66.7,1,2,0,2,1,4,3,0,"Matches","https://fbref.com/en/comps/9/defense/Premier-League-Stats"
"Morgan Gibbs-White","Nott'ham Forest",2023,"eng ENG","MF,FW",22,2000,33,26,14,7,7,12,11,32,34.4,21,23,4,19,14,40,15,0,"Matches","https://fbref.com/en/comps/9/defense/Premier-League-Stats"
"Billy Gilmour","Brighton",2023,"sct SCO","MF",21,2001,5.6,5,2,2,2,1,2,8,25,6,5,2,3,6,11,5,0,"Matches","https://fbref.com/en/comps/9/defense/Premier-League-Stats"
"Degnand Gnonto","Leeds United",2023,"it ITA","FW,MF",18,2003,15,27,17,7,15,5,10,30,33.3,20,24,1,23,5,32,7,0,"Matches","https://fbref.com/en/comps/9/defense/Premier-League-Stats"
"Ben Godfrey","Everton",2023,"eng ENG","DF",24,1998,8.9,20,11,13,5,2,11,29,37.9,18,12,6,6,8,28,33,1,"Matches","https://fbref.com/en/comps/9/defense/Premier-League-Stats"
"João Gomes","Wolves",2023,"br BRA","MF",21,2001,7.3,29,13,14,14,1,13,23,56.5,10,12,3,9,4,33,11,0,"Matches","https://fbref.com/en/comps/9/defense/Premier-League-Stats"
"Toti Gomes","Wolves",2023,"pt POR","DF",23,1999,10.9,15,9,11,4,0,9,13,69.2,4,16,8,8,11,26,51,0,"Matches","https://fbref.com/en/comps/9/defense/Premier-League-Stats"
"Joe Gomez","Liverpool",2023,"eng ENG","DF",25,1997,16.3,28,21,15,11,2,11,19,57.9,8,17,11,6,24,52,51,2,"Matches","https://fbref.com/en/comps/9/defense/Premier-League-Stats"
"Sergio Gómez","Manchester City",2023,"es ESP","DF,MF",21,2000,3.9,9,4,6,1,2,5,8,62.5,3,5,3,2,2,11,9,1,"Matches","https://fbref.com/en/comps/9/defense/Premier-League-Stats"
"Anthony Gordon","Newcastle Utd",2023,"eng ENG","FW,MF",21,2001,5.4,14,12,5,7,2,9,20,45,11,9,1,8,2,16,1,1,"Matches","https://fbref.com/en/comps/9/defense/Premier-League-Stats"
"Anthony Gordon","Everton",2023,"eng ENG","FW",21,2001,12.2,34,22,17,10,7,8,23,34.8,15,19,0,19,4,38,11,0,"Matches","https://fbref.com/en/comps/9/defense/Premier-League-Stats"
"Demarai Gray","Everton",2023,"eng ENG","FW,MF",26,1996,27.9,33,24,9,14,10,17,31,54.8,14,23,3,20,13,46,18,0,"Matches","https://fbref.com/en/comps/9/defense/Premier-League-Stats"
"Jack Grealish","Manchester City",2023,"eng ENG","FW",26,1995,22.8,25,16,10,12,3,13,22,59.1,9,17,3,14,7,32,9,0,"Matches","https://fbref.com/en/comps/9/defense/Premier-League-Stats"
"Sam Greenwood","Leeds United",2023,"eng ENG","MF,FW",20,2002,4.7,15,7,7,8,0,8,21,38.1,13,10,2,8,1,16,1,0,"Matches","https://fbref.com/en/comps/9/defense/Premier-League-Stats"
"Pascal Groß","Brighton",2023,"de GER","MF,DF",31,1991,36,59,38,23,27,9,25,55,45.5,30,32,10,22,13,72,21,1,"Matches","https://fbref.com/en/comps/9/defense/Premier-League-Stats"
"Vicente Guaita","Crystal Palace",2023,"es ESP","GK",35,1987,27,0,0,0,0,0,0,0,NA,0,0,0,0,0,0,9,1,"Matches","https://fbref.com/en/comps/9/defense/Premier-League-Stats"
"Gonçalo Guedes","Wolves",2023,"pt POR","FW,MF",25,1996,7.9,8,6,4,3,1,5,8,62.5,3,4,0,4,1,9,2,0,"Matches","https://fbref.com/en/comps/9/defense/Premier-League-Stats"
"Marc Guéhi","Crystal Palace",2023,"eng ENG","DF",22,2000,37,52,27,39,11,2,26,42,61.9,16,45,24,21,45,97,134,3,"Matches","https://fbref.com/en/comps/9/defense/Premier-League-Stats"
"Bruno Guimarães","Newcastle Utd",2023,"br BRA","MF",24,1997,30.3,78,40,27,46,5,38,65,58.5,27,28,4,24,36,114,22,1,"Matches","https://fbref.com/en/comps/9/defense/Premier-League-Stats"
"Ilkay Gündogan","Manchester City",2023,"de GER","MF",31,1990,26.1,30,18,7,13,10,12,33,36.4,21,18,3,15,20,50,13,0,"Matches","https://fbref.com/en/comps/9/defense/Premier-League-Stats"
"Darko Gyabi","Leeds United",2023,"eng ENG","FW",18,2004,0.1,2,2,1,1,0,0,0,NA,0,2,0,2,0,2,0,0,"Matches","https://fbref.com/en/comps/9/defense/Premier-League-Stats"
"Erling Haaland","Manchester City",2023,"no NOR","FW",22,2000,30.8,3,2,0,2,1,1,5,20,4,12,4,8,3,6,14,0,"Matches","https://fbref.com/en/comps/9/defense/Premier-League-Stats"
"Lewis Hall","Chelsea",2023,"eng ENG","DF",17,2004,7.3,23,12,19,4,0,15,22,68.2,7,8,0,8,11,34,11,1,"Matches","https://fbref.com/en/comps/9/defense/Premier-League-Stats"
"Luke Harris","Fulham",2023,"wls WAL","MF,FW",17,2005,0.1,0,0,0,0,0,0,0,NA,0,0,0,0,0,0,0,0,"Matches","https://fbref.com/en/comps/9/defense/Premier-League-Stats"
"Jack Harrison","Leeds United",2023,"eng ENG","FW,MF",25,1996,30.1,41,17,5,15,21,12,52,23.1,40,47,2,45,22,63,25,0,"Matches","https://fbref.com/en/comps/9/defense/Premier-League-Stats"
"Kai Havertz","Chelsea",2023,"de GER","FW,MF",23,1999,28.5,34,16,4,20,10,10,30,33.3,20,28,0,28,7,41,41,0,"Matches","https://fbref.com/en/comps/9/defense/Premier-League-Stats"
"Jan Paul van Hecke","Brighton",2023,"nl NED","DF",22,2000,3.3,8,6,3,4,1,5,5,100,0,8,5,3,6,14,9,0,"Matches","https://fbref.com/en/comps/9/defense/Premier-League-Stats"
"Hwang Hee-chan","Wolves",2023,"kr KOR","FW,MF",26,1996,12.6,20,9,7,8,5,6,19,31.6,13,18,2,16,5,25,5,0,"Matches","https://fbref.com/en/comps/9/defense/Premier-League-Stats"
"Dean Henderson","Nott'ham Forest",2023,"eng ENG","GK",25,1997,18,0,0,0,0,0,0,0,NA,0,0,0,0,0,0,12,1,"Matches","https://fbref.com/en/comps/9/defense/Premier-League-Stats"
"Jordan Henderson","Liverpool",2023,"eng ENG","MF",32,1990,23,32,23,10,18,4,15,36,41.7,21,21,3,18,21,53,16,1,"Matches","https://fbref.com/en/comps/9/defense/Premier-League-Stats"
"Wayne Hennessey","Nott'ham Forest",2023,"wls WAL","GK",35,1987,3,1,0,1,0,0,1,1,100,0,0,0,0,0,1,2,0,"Matches","https://fbref.com/en/comps/9/defense/Premier-League-Stats"
"Rico Henry","Brentford",2023,"eng ENG","DF",25,1997,36,57,31,20,28,9,22,41,53.7,19,29,8,21,30,87,84,1,"Matches","https://fbref.com/en/comps/9/defense/Premier-League-Stats"
"Son Heung-min","Tottenham",2023,"kr KOR","MF,FW",30,1992,32.1,24,12,7,8,9,9,30,30,21,23,2,21,13,37,6,0,"Matches","https://fbref.com/en/comps/9/defense/Premier-League-Stats"
"Aaron Hickey","Brentford",2023,"sct SCO","DF",20,2002,21.3,38,26,27,11,0,18,32,56.3,14,18,7,11,17,55,32,1,"Matches","https://fbref.com/en/comps/9/defense/Premier-League-Stats"
"Jack Hinshelwood","Brighton",2023,"eng ENG","FW",17,2005,0,1,0,1,0,0,0,0,NA,0,0,0,0,0,1,0,0,"Matches","https://fbref.com/en/comps/9/defense/Premier-League-Stats"
"Joseph Hodge","Wolves",2023,"ie IRL","MF",19,2002,1.9,5,2,1,3,1,3,4,75,1,5,0,5,0,5,2,1,"Matches","https://fbref.com/en/comps/9/defense/Premier-League-Stats"
"Rob Holding","Arsenal",2023,"eng ENG","DF",26,1995,6.3,8,5,4,4,0,3,6,50,3,6,5,1,3,11,27,1,"Matches","https://fbref.com/en/comps/9/defense/Premier-League-Stats"
"Mason Holgate","Everton",2023,"eng ENG","DF",25,1996,5.6,11,7,8,3,0,3,11,27.3,8,7,3,4,7,18,28,0,"Matches","https://fbref.com/en/comps/9/defense/Premier-League-Stats"
"Will Hughes","Crystal Palace",2023,"eng ENG","MF",27,1995,9.4,29,16,11,16,2,11,20,55,9,16,7,9,16,45,9,0,"Matches","https://fbref.com/en/comps/9/defense/Premier-League-Stats"
"Omari Hutchinson","Chelsea",2023,"eng ENG","FW",18,2003,0.3,0,0,0,0,0,0,0,NA,0,0,0,0,1,1,0,0,"Matches","https://fbref.com/en/comps/9/defense/Premier-League-Stats"
"Pierre Højbjerg","Tottenham",2023,"dk DEN","MF",26,1995,34.8,56,30,28,22,6,26,67,38.8,41,46,17,29,49,105,64,1,"Matches","https://fbref.com/en/comps/9/defense/Premier-League-Stats"
"Kelechi Iheanacho","Leicester City",2023,"ng NGA","FW,MF",25,1996,12.5,7,2,0,3,4,3,10,30,7,9,1,8,0,7,8,0,"Matches","https://fbref.com/en/comps/9/defense/Premier-League-Stats"
"Danny Ings","West Ham",2023,"eng ENG","FW",30,1992,8.6,9,8,0,4,5,5,14,35.7,9,8,2,6,3,12,5,0,"Matches","https://fbref.com/en/comps/9/defense/Premier-League-Stats"
"Danny Ings","Aston Villa",2023,"eng ENG","FW",30,1992,9.2,10,5,1,6,3,1,6,16.7,5,12,1,11,1,11,11,0,"Matches","https://fbref.com/en/comps/9/defense/Premier-League-Stats"
"Alexander Isak","Newcastle Utd",2023,"se SWE","FW",22,1999,16.9,18,8,4,7,7,10,28,35.7,18,21,2,19,4,22,8,0,"Matches","https://fbref.com/en/comps/9/defense/Premier-League-Stats"
"Daniel Iversen","Leicester City",2023,"dk DEN","GK",25,1997,12,0,0,0,0,0,0,0,NA,0,0,0,0,0,0,6,1,"Matches","https://fbref.com/en/comps/9/defense/Premier-League-Stats"
"Alex Iwobi","Everton",2023,"ng NGA","MF,FW",26,1996,37.5,69,37,37,28,4,33,65,50.8,32,41,2,39,25,94,29,0,"Matches","https://fbref.com/en/comps/9/defense/Premier-League-Stats"
"Daniel James","Leeds United",2023,"wls WAL","FW",24,1997,2.2,6,2,1,3,2,3,6,50,3,4,0,4,2,8,2,0,"Matches","https://fbref.com/en/comps/9/defense/Premier-League-Stats"
"Daniel James","Fulham",2023,"wls WAL","FW",24,1997,6.9,9,5,4,4,1,4,8,50,4,5,1,4,1,10,5,0,"Matches","https://fbref.com/en/comps/9/defense/Premier-League-Stats"
"Reece James","Chelsea",2023,"eng ENG","DF,MF",22,1999,13.8,31,20,10,18,3,15,19,78.9,4,17,2,15,12,43,23,0,"Matches","https://fbref.com/en/comps/9/defense/Premier-League-Stats"
"Vitaly Janelt","Brentford",2023,"de GER","MF,DF",24,1998,24.5,54,27,20,24,10,21,49,42.9,28,29,9,20,29,83,26,0,"Matches","https://fbref.com/en/comps/9/defense/Premier-League-Stats"
"Pontus Jansson","Brentford",2023,"se SWE","DF",31,1991,8,5,3,4,1,0,3,5,60,2,13,9,4,9,14,38,0,"Matches","https://fbref.com/en/comps/9/defense/Premier-League-Stats"
"Mathias Jensen","Brentford",2023,"dk DEN","MF",26,1996,31.1,70,35,28,30,12,34,97,35.1,63,54,5,49,32,102,24,1,"Matches","https://fbref.com/en/comps/9/defense/Premier-League-Stats"
"Gabriel Jesus","Arsenal",2023,"br BRA","FW",25,1997,22.9,33,25,16,8,9,15,31,48.4,16,27,3,24,11,44,15,1,"Matches","https://fbref.com/en/comps/9/defense/Premier-League-Stats"
"Raúl Jiménez","Wolves",2023,"mx MEX","FW",31,1991,9.4,9,6,3,5,1,3,6,50,3,9,0,9,0,9,8,0,"Matches","https://fbref.com/en/comps/9/defense/Premier-League-Stats"
"Joelinton","Newcastle Utd",2023,"br BRA","MF,FW",25,1996,29.6,70,49,36,26,8,26,62,41.9,36,52,7,45,48,118,39,0,"Matches","https://fbref.com/en/comps/9/defense/Premier-League-Stats"
"Ben Johnson","West Ham",2023,"eng ENG","DF",22,2000,9.6,20,14,12,4,4,12,18,66.7,6,12,4,8,9,29,28,1,"Matches","https://fbref.com/en/comps/9/defense/Premier-League-Stats"
"Brennan Johnson","Nott'ham Forest",2023,"wls WAL","FW,MF",21,2001,32.6,34,20,18,8,8,8,28,28.6,20,30,1,29,5,39,7,1,"Matches","https://fbref.com/en/comps/9/defense/Premier-League-Stats"
"Sam Johnstone","Crystal Palace",2023,"eng ENG","GK",29,1993,9,0,0,0,0,0,0,0,NA,0,0,0,0,0,0,5,0,"Matches","https://fbref.com/en/comps/9/defense/Premier-League-Stats"
"Curtis Jones","Liverpool",2023,"eng ENG","MF",21,2001,11.5,34,17,8,12,14,18,31,58.1,13,12,2,10,3,37,9,0,"Matches","https://fbref.com/en/comps/9/defense/Premier-League-Stats"
"Jorginho","Arsenal",2023,"it ITA","MF",30,1991,9.5,18,13,6,10,2,5,24,20.8,19,7,2,5,9,27,8,0,"Matches","https://fbref.com/en/comps/9/defense/Premier-League-Stats"
"Jorginho","Chelsea",2023,"it ITA","MF",30,1991,14.2,42,23,22,14,6,22,46,47.8,24,18,3,15,21,63,7,0,"Matches","https://fbref.com/en/comps/9/defense/Premier-League-Stats"
"Mateo Joseph","Leeds United",2023,"eng ENG","FW,MF",18,2003,0.3,0,0,0,0,0,0,0,NA,0,1,0,1,0,0,1,0,"Matches","https://fbref.com/en/comps/9/defense/Premier-League-Stats"
"Diogo Jota","Liverpool",2023,"pt POR","FW",25,1996,12.6,23,15,8,8,7,12,37,32.4,25,5,0,5,3,26,11,0,"Matches","https://fbref.com/en/comps/9/defense/Premier-League-Stats"
"Hamed Junior Traorè","Bournemouth",2023,"ci CIV","FW,MF",22,2000,4.7,17,11,5,9,3,6,18,33.3,12,9,0,9,2,19,1,0,"Matches","https://fbref.com/en/comps/9/defense/Premier-League-Stats"
"James Justin","Leicester City",2023,"eng ENG","DF",24,1998,13.9,20,18,7,12,1,9,14,64.3,5,24,6,18,15,35,47,0,"Matches","https://fbref.com/en/comps/9/defense/Premier-League-Stats"
"Mathias Jørgensen","Brentford",2023,"dk DEN","DF",32,1990,12.3,17,8,9,8,0,9,21,42.9,12,19,12,7,16,33,39,1,"Matches","https://fbref.com/en/comps/9/defense/Premier-League-Stats"
"Sasa Kalajdzic","Wolves",2023,"at AUT","FW",25,1997,0.5,0,0,0,0,0,0,0,NA,0,0,0,0,1,1,0,0,"Matches","https://fbref.com/en/comps/9/defense/Premier-League-Stats"
"Boubacar Kamara","Aston Villa",2023,"fr FRA","MF",22,1999,19.7,58,25,25,23,10,27,56,48.2,29,38,12,26,19,77,24,2,"Matches","https://fbref.com/en/comps/9/defense/Premier-League-Stats"
"Harry Kane","Tottenham",2023,"eng ENG","FW",29,1993,37.8,15,12,1,6,8,7,21,33.3,14,27,7,20,2,17,18,0,"Matches","https://fbref.com/en/comps/9/defense/Premier-League-Stats"
"N'Golo Kanté","Chelsea",2023,"fr FRA","MF",31,1991,5.8,16,10,4,10,2,4,8,50,4,11,0,11,6,22,2,0,"Matches","https://fbref.com/en/comps/9/defense/Premier-League-Stats"
"Michael Keane","Everton",2023,"eng ENG","DF",29,1993,10.9,7,4,5,2,0,5,8,62.5,3,12,7,5,14,21,55,1,"Matches","https://fbref.com/en/comps/9/defense/Premier-League-Stats"
"Neeskens Kebano","Fulham",2023,"cd COD","FW",30,1992,8.5,17,9,8,6,3,9,17,52.9,8,14,0,14,1,18,8,0,"Matches","https://fbref.com/en/comps/9/defense/Premier-League-Stats"
"Thilo Kehrer","West Ham",2023,"de GER","DF",25,1996,24.8,43,24,25,14,4,21,44,47.7,23,16,6,10,34,77,76,1,"Matches","https://fbref.com/en/comps/9/defense/Premier-League-Stats"
"Naby Keïta","Liverpool",2023,"gn GUI","MF",27,1995,3.3,5,4,2,3,0,1,4,25,3,1,0,1,2,7,3,0,"Matches","https://fbref.com/en/comps/9/defense/Premier-League-Stats"
"Caoimhín Kelleher","Liverpool",2023,"ie IRL","GK",23,1998,1,0,0,0,0,0,0,0,NA,0,0,0,0,0,0,0,0,"Matches","https://fbref.com/en/comps/9/defense/Premier-League-Stats"
"Lloyd Kelly","Bournemouth",2023,"eng ENG","DF",23,1998,22.7,33,18,23,9,1,13,19,68.4,6,26,15,11,26,59,101,1,"Matches","https://fbref.com/en/comps/9/defense/Premier-League-Stats"
"Max Kilman","Wolves",2023,"eng ENG","DF",25,1997,36.7,36,20,26,9,1,16,30,53.3,14,70,42,28,19,55,164,1,"Matches","https://fbref.com/en/comps/9/defense/Premier-League-Stats"
"Jakub Kiwior","Arsenal",2023,"pl POL","DF",22,2000,4.7,7,5,6,1,0,5,8,62.5,3,5,3,2,6,13,10,0,"Matches","https://fbref.com/en/comps/9/defense/Premier-League-Stats"
"Mateusz Klich","Leeds United",2023,"pl POL","MF,FW",32,1990,3.1,12,8,3,4,5,7,13,53.8,6,4,0,4,0,12,1,0,"Matches","https://fbref.com/en/comps/9/defense/Premier-League-Stats"
"Robin Koch","Leeds United",2023,"de GER","DF",26,1996,35.3,53,30,32,16,5,24,56,42.9,32,44,21,23,43,96,152,1,"Matches","https://fbref.com/en/comps/9/defense/Premier-League-Stats"
"Ibrahima Konaté","Liverpool",2023,"fr FRA","DF",23,1999,17.2,38,26,25,13,0,16,27,59.3,11,12,5,7,26,64,61,4,"Matches","https://fbref.com/en/comps/9/defense/Premier-League-Stats"
"Ezri Konsa","Aston Villa",2023,"eng ENG","DF",24,1997,36.9,42,20,25,15,2,18,26,69.2,8,41,23,18,26,68,120,3,"Matches","https://fbref.com/en/comps/9/defense/Premier-League-Stats"
"Kalidou Koulibaly","Chelsea",2023,"sn SEN","DF",31,1991,20,45,31,34,8,3,26,40,65,14,30,13,17,29,74,77,0,"Matches","https://fbref.com/en/comps/9/defense/Premier-League-Stats"
"Cheikhou Kouyaté","Nott'ham Forest",2023,"sn SEN","MF",32,1989,9.8,29,21,18,8,3,9,13,69.2,4,14,2,12,10,39,24,0,"Matches","https://fbref.com/en/comps/9/defense/Premier-League-Stats"
"Mateo Kovacic","Chelsea",2023,"hr CRO","MF",28,1994,19,36,24,16,14,6,14,36,38.9,22,10,1,9,19,55,16,0,"Matches","https://fbref.com/en/comps/9/defense/Premier-League-Stats"
"Emil Krafth","Newcastle Utd",2023,"se SWE","DF",27,1994,0,0,0,0,0,0,0,0,NA,0,0,0,0,0,0,0,0,"Matches","https://fbref.com/en/comps/9/defense/Premier-League-Stats"
"Dejan Kulusevski","Tottenham",2023,"se SWE","MF,FW",22,2000,23,38,15,23,7,8,16,44,36.4,28,19,0,19,13,51,7,0,"Matches","https://fbref.com/en/comps/9/defense/Premier-League-Stats"
"Layvin Kurzawa","Fulham",2023,"fr FRA","DF",29,1992,1.5,3,2,1,1,1,3,3,100,0,1,1,0,2,5,4,0,"Matches","https://fbref.com/en/comps/9/defense/Premier-League-Stats"
"Adam Lallana","Brighton",2023,"eng ENG","MF,FW",34,1988,8,9,4,6,2,1,0,7,0,7,6,0,6,2,11,1,0,"Matches","https://fbref.com/en/comps/9/defense/Premier-League-Stats"
"Tariq Lamptey","Brighton",2023,"gh GHA","DF",21,2000,5,11,6,6,4,1,5,7,71.4,2,7,3,4,7,18,2,0,"Matches","https://fbref.com/en/comps/9/defense/Premier-League-Stats"
"Manuel Lanzini","West Ham",2023,"ar ARG","MF,FW",29,1993,2.8,2,2,1,1,0,2,6,33.3,4,2,0,2,2,4,0,0,"Matches","https://fbref.com/en/comps/9/defense/Premier-League-Stats"
"Aymeric Laporte","Manchester City",2023,"es ESP","DF",28,1994,11,11,8,6,4,1,7,11,63.6,4,10,4,6,3,14,30,1,"Matches","https://fbref.com/en/comps/9/defense/Premier-League-Stats"
"Juan Larios","Southampton",2023,"es ESP","DF",18,2004,1.7,7,6,6,1,0,5,5,100,0,2,0,2,3,10,4,0,"Matches","https://fbref.com/en/comps/9/defense/Premier-League-Stats"
"Jamaal Lascelles","Newcastle Utd",2023,"eng ENG","DF",28,1993,2.4,1,0,1,0,0,1,1,100,0,3,2,1,0,1,17,0,"Matches","https://fbref.com/en/comps/9/defense/Premier-League-Stats"
"Roméo Lavia","Southampton",2023,"be BEL","MF",18,2004,24.7,60,35,27,29,4,21,53,39.6,32,47,11,36,33,93,23,1,"Matches","https://fbref.com/en/comps/9/defense/Premier-League-Stats"
"Dexter Lembikisa","Wolves",2023,"jm JAM","DF",18,2003,0.3,0,0,0,0,0,0,0,NA,0,0,0,0,0,0,0,0,"Matches","https://fbref.com/en/comps/9/defense/Premier-League-Stats"
"Mario Lemina","Wolves",2023,"ga GAB","MF",28,1993,14.4,38,24,22,13,3,20,38,52.6,18,26,8,18,14,52,24,1,"Matches","https://fbref.com/en/comps/9/defense/Premier-League-Stats"
"Clément Lenglet","Tottenham",2023,"fr FRA","DF",27,1995,22.4,38,23,18,15,5,16,34,47.1,18,26,11,15,18,56,68,2,"Matches","https://fbref.com/en/comps/9/defense/Premier-League-Stats"
"Bernd Leno","Fulham",2023,"de GER","GK",30,1992,36,0,0,0,0,0,0,2,0,2,0,0,0,0,0,18,0,"Matches","https://fbref.com/en/comps/9/defense/Premier-League-Stats"
"Jefferson Lerma","Bournemouth",2023,"co COL","MF",27,1994,36.1,50,30,23,23,4,20,45,44.4,25,32,15,17,47,97,91,1,"Matches","https://fbref.com/en/comps/9/defense/Premier-League-Stats"
"Jamal Lewis","Newcastle Utd",2023,"nir NIR","DF,FW",24,1998,0.1,0,0,0,0,0,0,0,NA,0,0,0,0,0,0,0,0,"Matches","https://fbref.com/en/comps/9/defense/Premier-League-Stats"
"Rico Lewis","Manchester City",2023,"eng ENG","DF,MF",17,2004,10,16,9,9,5,2,6,11,54.5,5,8,4,4,6,22,13,1,"Matches","https://fbref.com/en/comps/9/defense/Premier-League-Stats"
"Keane Lewis-Potter","Brentford",2023,"eng ENG","FW,MF",21,2001,3.6,1,0,0,1,0,0,0,NA,0,5,1,4,0,1,2,0,"Matches","https://fbref.com/en/comps/9/defense/Premier-League-Stats"
"Victor Lindelöf","Manchester Utd",2023,"se SWE","DF",28,1994,15.2,22,17,10,9,3,9,17,52.9,8,18,9,9,21,43,63,1,"Matches","https://fbref.com/en/comps/9/defense/Premier-League-Stats"
"Jesse Lingard","Nott'ham Forest",2023,"eng ENG","FW,MF",29,1992,10.3,4,4,2,2,0,1,7,14.3,6,11,0,11,5,9,4,0,"Matches","https://fbref.com/en/comps/9/defense/Premier-League-Stats"
"Valentino Livramento","Southampton",2023,"eng ENG","DF,FW",19,2002,0.3,2,1,2,0,0,0,0,NA,0,0,0,0,2,4,3,0,"Matches","https://fbref.com/en/comps/9/defense/Premier-League-Stats"
"Diego Llorente","Leeds United",2023,"es ESP","DF",28,1993,7.2,13,10,8,5,0,4,8,50,4,6,2,4,15,28,24,2,"Matches","https://fbref.com/en/comps/9/defense/Premier-League-Stats"
"Hugo Lloris","Tottenham",2023,"fr FRA","GK",35,1986,24.5,1,1,1,0,0,1,3,33.3,2,0,0,0,1,2,13,4,"Matches","https://fbref.com/en/comps/9/defense/Premier-League-Stats"
"Renan Lodi","Nott'ham Forest",2023,"br BRA","DF",24,1998,24.6,52,39,38,8,6,33,66,50,33,25,6,19,33,85,74,0,"Matches","https://fbref.com/en/comps/9/defense/Premier-League-Stats"
"Ruben Loftus-Cheek","Chelsea",2023,"eng ENG","MF,DF",26,1996,17.1,25,14,8,14,3,12,21,57.1,9,15,2,13,12,37,23,0,"Matches","https://fbref.com/en/comps/9/defense/Premier-League-Stats"
"Sean Longstaff","Newcastle Utd",2023,"eng ENG","MF",24,1997,28,42,21,16,20,6,20,52,38.5,32,35,8,27,16,58,23,0,"Matches","https://fbref.com/en/comps/9/defense/Premier-League-Stats"
"Jamal Lowe","Bournemouth",2023,"jm JAM","MF,FW",28,1994,0.1,0,0,0,0,0,0,0,NA,0,0,0,0,0,0,0,0,"Matches","https://fbref.com/en/comps/9/defense/Premier-League-Stats"
"Douglas Luiz","Aston Villa",2023,"br BRA","MF",24,1998,32.5,73,42,31,32,10,30,63,47.6,33,36,7,29,40,113,27,2,"Matches","https://fbref.com/en/comps/9/defense/Premier-League-Stats"
"Saa Lukic","Fulham",2023,"rs SRB","MF",25,1996,4.6,8,3,1,4,3,3,7,42.9,4,6,2,4,5,13,3,0,"Matches","https://fbref.com/en/comps/9/defense/Premier-League-Stats"
"Lyanco","Southampton",2023,"br BRA","DF",25,1997,13.1,24,16,15,9,0,12,18,66.7,6,30,25,5,20,44,65,2,"Matches","https://fbref.com/en/comps/9/defense/Premier-League-Stats"
"Alexis Mac Allister","Brighton",2023,"ar ARG","MF",23,1998,32.1,70,39,22,40,8,34,70,48.6,36,26,2,24,22,92,10,1,"Matches","https://fbref.com/en/comps/9/defense/Premier-League-Stats"
"James Maddison","Leicester City",2023,"eng ENG","MF,FW",25,1996,27.6,51,26,25,19,7,19,50,38,31,19,1,18,13,64,6,1,"Matches","https://fbref.com/en/comps/9/defense/Premier-League-Stats"
"Noni Madueke","Chelsea",2023,"eng ENG","FW",20,2002,7.1,12,8,5,4,3,6,13,46.2,7,13,2,11,4,16,7,0,"Matches","https://fbref.com/en/comps/9/defense/Premier-League-Stats"
"Harry Maguire","Manchester Utd",2023,"eng ENG","DF",29,1993,8.5,8,6,6,1,1,4,5,80,1,18,11,7,13,21,41,0,"Matches","https://fbref.com/en/comps/9/defense/Premier-League-Stats"
"Riyad Mahrez","Manchester City",2023,"dz ALG","FW,MF",31,1991,21.3,30,14,8,13,9,13,38,34.2,25,27,1,26,9,39,5,0,"Matches","https://fbref.com/en/comps/9/defense/Premier-League-Stats"
"Kobbie Mainoo","Manchester Utd",2023,"eng ENG","MF",17,2005,0.1,0,0,0,0,0,0,0,NA,0,1,1,0,0,0,0,0,"Matches","https://fbref.com/en/comps/9/defense/Premier-League-Stats"
"Ainsley Maitland-Niles","Southampton",2023,"eng ENG","DF,MF",24,1997,15.6,45,24,23,18,4,28,44,63.6,16,28,7,21,22,67,45,1,"Matches","https://fbref.com/en/comps/9/defense/Premier-League-Stats"
"Tyrell Malacia","Manchester Utd",2023,"nl NED","DF",22,1999,15.5,46,33,33,12,1,14,25,56,11,13,3,10,25,71,49,0,"Matches","https://fbref.com/en/comps/9/defense/Premier-League-Stats"
"Orel Mangala","Nott'ham Forest",2023,"be BEL","MF",24,1998,17.2,28,20,16,10,2,12,29,41.4,17,21,7,14,23,51,15,0,"Matches","https://fbref.com/en/comps/9/defense/Premier-League-Stats"
"Javier Manquillo","Newcastle Utd",2023,"es ESP","DF",28,1994,0.4,3,2,2,1,0,2,2,100,0,1,0,1,1,4,1,0,"Matches","https://fbref.com/en/comps/9/defense/Premier-League-Stats"
"Sekou Mara","Southampton",2023,"fr FRA","FW,MF",20,2002,6.2,14,10,5,8,1,3,9,33.3,6,11,0,11,1,15,5,0,"Matches","https://fbref.com/en/comps/9/defense/Premier-League-Stats"
"Solly March","Brighton",2023,"eng ENG","FW,DF",28,1994,30.2,53,31,16,17,20,8,28,28.6,20,34,3,31,24,77,32,0,"Matches","https://fbref.com/en/comps/9/defense/Premier-League-Stats"
"Emiliano Marcondes","Bournemouth",2023,"dk DEN","MF",27,1995,0.1,0,0,0,0,0,0,0,NA,0,0,0,0,0,0,1,0,"Matches","https://fbref.com/en/comps/9/defense/Premier-League-Stats"
"Marquinhos","Arsenal",2023,"br BRA","MF",19,2003,0,0,0,0,0,0,0,0,NA,0,0,0,0,0,0,0,0,"Matches","https://fbref.com/en/comps/9/defense/Premier-League-Stats"
"Anthony Martial","Manchester Utd",2023,"fr FRA","FW",26,1995,10.9,5,3,0,2,3,1,4,25,3,11,2,9,1,6,4,0,"Matches","https://fbref.com/en/comps/9/defense/Premier-League-Stats"
"Martinelli","Arsenal",2023,"br BRA","FW",21,2001,31,31,18,13,12,6,9,22,40.9,13,24,1,23,9,40,14,0,"Matches","https://fbref.com/en/comps/9/defense/Premier-League-Stats"
"Emiliano Martínez","Aston Villa",2023,"ar ARG","GK",29,1992,34.9,0,0,0,0,0,0,2,0,2,0,0,0,1,1,23,1,"Matches","https://fbref.com/en/comps/9/defense/Premier-League-Stats"
"Lisandro Martínez","Manchester Utd",2023,"ar ARG","DF",24,1998,23.5,54,28,33,18,3,30,43,69.8,13,51,27,24,33,87,103,0,"Matches","https://fbref.com/en/comps/9/defense/Premier-League-Stats"
"Pape Matar Sarr","Tottenham",2023,"sn SEN","MF,FW",19,2002,2.4,7,6,4,2,1,4,8,50,4,3,2,1,6,13,6,0,"Matches","https://fbref.com/en/comps/9/defense/Premier-League-Stats"
"Jean-Philippe Mateta","Crystal Palace",2023,"fr FRA","FW",25,1997,8.6,7,1,2,4,1,1,3,33.3,2,3,1,2,3,10,18,0,"Matches","https://fbref.com/en/comps/9/defense/Premier-League-Stats"
"Joël Matip","Liverpool",2023,"cm CMR","DF",30,1991,12.1,14,8,12,2,0,11,23,47.8,12,8,3,5,21,35,45,3,"Matches","https://fbref.com/en/comps/9/defense/Premier-League-Stats"
"Neal Maupay","Everton",2023,"fr FRA","FW",25,1996,12.4,11,5,3,4,4,2,4,50,2,8,0,8,5,16,0,0,"Matches","https://fbref.com/en/comps/9/defense/Premier-League-Stats"
"Kevin Mbabu","Fulham",2023,"ch SUI","DF,FW",27,1995,1.6,3,2,2,1,0,1,3,33.3,2,2,0,2,3,6,3,0,"Matches","https://fbref.com/en/comps/9/defense/Premier-League-Stats"
"Bryan Mbeumo","Brentford",2023,"cm CMR","FW",22,1999,32.3,26,18,5,13,8,8,42,19,34,24,1,23,13,39,21,0,"Matches","https://fbref.com/en/comps/9/defense/Premier-League-Stats"
"James McArthur","Crystal Palace",2023,"sct SCO","MF",34,1987,0.6,1,1,1,0,0,1,1,100,0,2,1,1,1,2,2,0,"Matches","https://fbref.com/en/comps/9/defense/Premier-League-Stats"
"Alex McCarthy","Southampton",2023,"eng ENG","GK",32,1989,6,0,0,0,0,0,0,1,0,1,0,0,0,1,1,3,1,"Matches","https://fbref.com/en/comps/9/defense/Premier-League-Stats"
"John McGinn","Aston Villa",2023,"sct SCO","MF,FW",27,1994,29.9,66,36,27,29,10,34,71,47.9,37,43,4,39,24,90,19,0,"Matches","https://fbref.com/en/comps/9/defense/Premier-League-Stats"
"Scott McKenna","Nott'ham Forest",2023,"sct SCO","DF",25,1996,17.5,12,7,7,3,2,6,10,60,4,20,14,6,12,24,85,1,"Matches","https://fbref.com/en/comps/9/defense/Premier-League-Stats"
"Weston McKennie","Leeds United",2023,"us USA","MF",23,1998,16,30,13,5,18,7,10,29,34.5,19,22,3,19,22,52,26,0,"Matches","https://fbref.com/en/comps/9/defense/Premier-League-Stats"
"Dwight McNeil","Everton",2023,"eng ENG","FW,MF",22,1999,27.8,64,41,35,14,15,27,62,43.5,35,46,7,39,31,95,41,0,"Matches","https://fbref.com/en/comps/9/defense/Premier-League-Stats"
"Scott McTominay","Manchester Utd",2023,"sct SCO","MF",25,1996,12.9,32,19,16,10,6,13,22,59.1,9,15,6,9,14,46,45,0,"Matches","https://fbref.com/en/comps/9/defense/Premier-League-Stats"
"Ben Mee","Brentford",2023,"eng ENG","DF",32,1989,36.3,45,24,28,13,4,20,37,54.1,17,54,42,12,48,93,122,1,"Matches","https://fbref.com/en/comps/9/defense/Premier-League-Stats"
"Edouard Mendy","Chelsea",2023,"sn SEN","GK",30,1992,9.5,0,0,0,0,0,0,0,NA,0,0,0,0,0,0,3,3,"Matches","https://fbref.com/en/comps/9/defense/Premier-League-Stats"
"Nampalys Mendy","Leicester City",2023,"sn SEN","MF",30,1992,8.4,13,9,7,6,0,8,15,53.3,7,20,4,16,13,26,2,0,"Matches","https://fbref.com/en/comps/9/defense/Premier-League-Stats"
"Chris Mepham","Bournemouth",2023,"wls WAL","DF",24,1997,24.4,45,22,37,8,0,19,30,63.3,11,40,27,13,30,75,152,0,"Matches","https://fbref.com/en/comps/9/defense/Premier-League-Stats"
"Illan Meslier","Leeds United",2023,"fr FRA","GK",22,2000,34,2,1,2,0,0,2,4,50,2,0,0,0,1,3,30,3,"Matches","https://fbref.com/en/comps/9/defense/Premier-League-Stats"
"Alexander Mighten","Nott'ham Forest",2023,"eng ENG","FW",20,2002,0.1,0,0,0,0,0,0,1,0,1,0,0,0,0,0,0,0,"Matches","https://fbref.com/en/comps/9/defense/Premier-League-Stats"
"Lewis Miley","Newcastle Utd",2023,"eng ENG","MF",16,2006,0.2,0,0,0,0,0,0,0,NA,0,1,0,1,0,0,0,0,"Matches","https://fbref.com/en/comps/9/defense/Premier-League-Stats"
"Luka Milivojevic","Crystal Palace",2023,"rs SRB","MF",31,1991,5.7,13,7,7,4,2,7,10,70,3,13,4,9,12,25,10,0,"Matches","https://fbref.com/en/comps/9/defense/Premier-League-Stats"
"James Milner","Liverpool",2023,"eng ENG","MF,DF",36,1986,10.1,26,16,11,11,4,15,34,44.1,19,14,2,12,12,38,15,0,"Matches","https://fbref.com/en/comps/9/defense/Premier-League-Stats"
"Yerry Mina","Everton",2023,"co COL","DF",27,1994,6.6,15,8,9,6,0,9,11,81.8,2,7,4,3,6,21,28,0,"Matches","https://fbref.com/en/comps/9/defense/Premier-League-Stats"
"Tyrone Mings","Aston Villa",2023,"eng ENG","DF",29,1993,35,15,7,10,5,0,9,20,45,11,40,21,19,54,69,163,2,"Matches","https://fbref.com/en/comps/9/defense/Premier-League-Stats"
"Tyrick Mitchell","Crystal Palace",2023,"eng ENG","DF",22,1999,32.1,71,49,43,23,5,30,53,56.6,23,48,11,37,42,113,78,0,"Matches","https://fbref.com/en/comps/9/defense/Premier-League-Stats"
"Kaoru Mitoma","Brighton",2023,"jp JPN","FW,MF",25,1997,25.8,44,27,15,16,13,20,41,48.8,21,25,0,25,17,61,10,0,"Matches","https://fbref.com/en/comps/9/defense/Premier-League-Stats"
"Aleksandar Mitrovic","Fulham",2023,"rs SRB","FW",27,1994,22.3,14,7,8,4,2,5,12,41.7,7,22,5,17,3,17,20,1,"Matches","https://fbref.com/en/comps/9/defense/Premier-League-Stats"
"Kieffer Moore","Bournemouth",2023,"wls WAL","FW",29,1992,14.2,14,11,2,9,3,5,16,31.3,11,12,5,7,1,15,26,0,"Matches","https://fbref.com/en/comps/9/defense/Premier-League-Stats"
"Andrew Moran","Brighton",2023,"ie IRL","FW",18,2003,0.1,0,0,0,0,0,0,0,NA,0,1,0,1,0,0,0,0,"Matches","https://fbref.com/en/comps/9/defense/Premier-League-Stats"
"Álex Moreno","Aston Villa",2023,"es ESP","DF",29,1993,14.8,23,14,15,5,3,13,36,36.1,23,18,3,15,7,30,37,2,"Matches","https://fbref.com/en/comps/9/defense/Premier-League-Stats"
"Mason Mount","Chelsea",2023,"eng ENG","MF,FW",23,1999,18.3,33,19,6,16,11,14,27,51.9,13,24,6,18,8,41,9,0,"Matches","https://fbref.com/en/comps/9/defense/Premier-League-Stats"
"Lucas Moura","Tottenham",2023,"br BRA","MF,DF",29,1992,1.7,8,5,1,3,4,1,4,25,3,0,0,0,2,10,1,1,"Matches","https://fbref.com/en/comps/9/defense/Premier-League-Stats"
"João Moutinho","Wolves",2023,"pt POR","MF",35,1986,19.8,51,30,24,21,6,19,46,41.3,27,22,6,16,18,69,20,0,"Matches","https://fbref.com/en/comps/9/defense/Premier-League-Stats"
"Divin Mubama","West Ham",2023,"eng ENG","FW",17,2004,0.4,1,1,1,0,0,0,0,NA,0,0,0,0,0,1,0,0,"Matches","https://fbref.com/en/comps/9/defense/Premier-League-Stats"
"Mykhailo Mudryk","Chelsea",2023,"ua UKR","FW,MF",21,2001,7.3,11,9,2,4,5,4,13,30.8,9,7,1,6,0,11,3,0,"Matches","https://fbref.com/en/comps/9/defense/Premier-League-Stats"
"Jacob Murphy","Newcastle Utd",2023,"eng ENG","FW",27,1995,13.9,15,7,3,8,4,8,20,40,12,17,0,17,7,22,3,0,"Matches","https://fbref.com/en/comps/9/defense/Premier-League-Stats"
"Enock Mwepu","Brighton",2023,"zm ZAM","FW,MF",24,1998,2.4,10,5,1,6,3,3,4,75,1,3,1,2,1,11,1,0,"Matches","https://fbref.com/en/comps/9/defense/Premier-League-Stats"
"Vitaliy Mykolenko","Everton",2023,"ua UKR","DF",23,1999,29.5,58,34,36,19,3,28,51,54.9,23,50,16,34,46,104,99,0,"Matches","https://fbref.com/en/comps/9/defense/Premier-League-Stats"
"Keylor Navas","Nott'ham Forest",2023,"cr CRC","GK",35,1986,17,0,0,0,0,0,0,0,NA,0,0,0,0,1,1,11,1,"Matches","https://fbref.com/en/comps/9/defense/Premier-League-Stats"
"Wilfred Ndidi","Leicester City",2023,"ng NGA","MF",25,1996,18.7,61,42,34,24,3,17,43,39.5,26,32,14,18,38,99,48,3,"Matches","https://fbref.com/en/comps/9/defense/Premier-League-Stats"
"Reiss Nelson","Arsenal",2023,"eng ENG","FW",22,1999,2.4,4,1,2,1,1,2,4,50,2,3,0,3,0,4,4,0,"Matches","https://fbref.com/en/comps/9/defense/Premier-League-Stats"
"Neto","Bournemouth",2023,"br BRA","GK",33,1989,26.5,3,1,3,0,0,3,3,100,0,0,0,0,0,3,10,3,"Matches","https://fbref.com/en/comps/9/defense/Premier-League-Stats"
"Pedro Neto","Wolves",2023,"pt POR","FW,MF",22,2000,10.7,11,6,4,2,5,7,17,41.2,10,5,1,4,4,15,4,0,"Matches","https://fbref.com/en/comps/9/defense/Premier-League-Stats"
"Rúben Neves","Wolves",2023,"pt POR","MF",25,1997,33.5,79,43,31,33,15,32,74,43.2,42,59,22,37,50,129,85,1,"Matches","https://fbref.com/en/comps/9/defense/Premier-League-Stats"
"Moussa Niakhate","Nott'ham Forest",2023,"sn SEN","DF",26,1996,12.9,18,9,15,3,0,11,22,50,11,18,8,10,19,37,60,0,"Matches","https://fbref.com/en/comps/9/defense/Premier-League-Stats"
"Rasmus Nissen","Leeds United",2023,"dk DEN","DF",25,1997,21.8,62,35,35,21,6,42,76,55.3,34,32,14,18,35,97,61,0,"Matches","https://fbref.com/en/comps/9/defense/Premier-League-Stats"
"Eddie Nketiah","Arsenal",2023,"eng ENG","FW",23,1999,12.1,13,9,6,2,5,2,8,25,6,7,1,6,1,14,7,0,"Matches","https://fbref.com/en/comps/9/defense/Premier-League-Stats"
"Matheus Nunes","Wolves",2023,"pt POR","MF",23,1998,27.4,67,43,36,22,9,28,61,45.9,33,35,4,31,16,83,35,2,"Matches","https://fbref.com/en/comps/9/defense/Premier-League-Stats"
"Darwin Núñez","Liverpool",2023,"uy URU","FW",23,1999,18.8,11,5,2,4,5,4,17,23.5,13,10,0,10,3,14,13,0,"Matches","https://fbref.com/en/comps/9/defense/Premier-League-Stats"
"Ethan Nwaneri","Arsenal",2023,"eng ENG","FW",15,2007,0,0,0,0,0,0,0,0,NA,0,1,0,1,0,0,0,0,"Matches","https://fbref.com/en/comps/9/defense/Premier-League-Stats"
"Christian Nørgaard","Brentford",2023,"dk DEN","MF",28,1994,19.6,52,30,21,29,2,18,48,37.5,30,32,9,23,34,86,41,2,"Matches","https://fbref.com/en/comps/9/defense/Premier-League-Stats"
"Lewis O'Brien","Nott'ham Forest",2023,"eng ENG","MF",23,1998,6.5,16,9,4,11,1,6,12,50,6,13,2,11,5,21,9,0,"Matches","https://fbref.com/en/comps/9/defense/Premier-League-Stats"
"Odeluga Offiah","Brighton",2023,"eng ENG","DF",19,2002,0.3,1,1,1,0,0,0,2,0,2,0,0,0,0,1,1,0,"Matches","https://fbref.com/en/comps/9/defense/Premier-League-Stats"
"Angelo Ogbonna","West Ham",2023,"it ITA","DF",34,1988,13.7,11,4,7,4,0,5,10,50,5,11,7,4,17,28,74,1,"Matches","https://fbref.com/en/comps/9/defense/Premier-League-Stats"
"Michael Olise","Crystal Palace",2023,"fr FRA","FW,MF",20,2001,30.5,58,34,28,26,4,25,60,41.7,35,46,1,45,26,84,17,0,"Matches","https://fbref.com/en/comps/9/defense/Premier-League-Stats"
"Robin Olsen","Aston Villa",2023,"se SWE","GK",32,1990,3.1,0,0,0,0,0,0,2,0,2,0,0,0,0,0,1,0,"Matches","https://fbref.com/en/comps/9/defense/Premier-League-Stats"
"Amadou Onana","Everton",2023,"be BEL","MF",20,2001,27.6,72,43,24,42,6,30,42,71.4,12,25,6,19,37,109,39,0,"Matches","https://fbref.com/en/comps/9/defense/Premier-League-Stats"
"Josh Onomah","Fulham",2023,"eng ENG","MF",25,1997,0.2,1,0,1,0,0,0,0,NA,0,1,0,1,0,1,0,0,"Matches","https://fbref.com/en/comps/9/defense/Premier-League-Stats"
"Paul Onuachu","Southampton",2023,"ng NGA","FW",28,1994,4.5,3,2,1,1,1,1,3,33.3,2,4,1,3,0,3,4,0,"Matches","https://fbref.com/en/comps/9/defense/Premier-League-Stats"
"Frank Onyeka","Brentford",2023,"ng NGA","MF",24,1998,9.4,19,14,11,7,1,10,25,40,15,16,3,13,10,29,16,0,"Matches","https://fbref.com/en/comps/9/defense/Premier-League-Stats"
"Mislav Oric","Southampton",2023,"hr CRO","MF",29,1992,0.1,1,1,1,0,0,0,0,NA,0,0,0,0,0,1,0,0,"Matches","https://fbref.com/en/comps/9/defense/Premier-League-Stats"
"Stefan Ortega","Manchester City",2023,"de GER","GK",29,1992,3,0,0,0,0,0,0,0,NA,0,0,0,0,0,0,0,0,"Matches","https://fbref.com/en/comps/9/defense/Premier-League-Stats"
"Dango Ouattara","Bournemouth",2023,"bf BFA","MF,FW",20,2002,13.8,28,15,20,6,2,13,32,40.6,19,20,3,17,13,41,29,1,"Matches","https://fbref.com/en/comps/9/defense/Premier-League-Stats"
"Alex Oxlade-Chamberlain","Liverpool",2023,"eng ENG","FW,MF",28,1993,3.7,5,4,1,2,2,1,5,20,4,5,2,3,1,6,4,0,"Matches","https://fbref.com/en/comps/9/defense/Premier-League-Stats"
"David Ozoh","Crystal Palace",2023,NA,"FW",17,2005,0,0,0,0,0,0,0,0,NA,0,0,0,0,0,0,0,0,"Matches","https://fbref.com/en/comps/9/defense/Premier-League-Stats"
"João Palhinha","Fulham",2023,"pt POR","MF",27,1995,34.5,147,83,58,65,24,71,134,53,63,48,5,43,46,193,61,2,"Matches","https://fbref.com/en/comps/9/defense/Premier-League-Stats"
"Cole Palmer","Manchester City",2023,"eng ENG","MF,FW",20,2002,4.1,5,1,0,3,2,3,5,60,2,2,1,1,1,6,2,0,"Matches","https://fbref.com/en/comps/9/defense/Premier-League-Stats"
"Emerson Palmieri","West Ham",2023,"it ITA","DF",27,1994,14.7,26,14,9,15,2,12,24,50,12,17,4,13,15,41,36,0,"Matches","https://fbref.com/en/comps/9/defense/Premier-League-Stats"
"Lucas Paquetá","West Ham",2023,"br BRA","MF",24,1997,23.9,71,53,23,36,12,27,66,40.9,39,41,4,37,16,87,31,0,"Matches","https://fbref.com/en/comps/9/defense/Premier-League-Stats"
"Thomas Partey","Arsenal",2023,"gh GHA","MF",29,1993,27.6,70,40,20,35,15,25,52,48.1,27,26,5,21,28,98,41,1,"Matches","https://fbref.com/en/comps/9/defense/Premier-League-Stats"
"Nathan Patterson","Everton",2023,"sct SCO","DF,MF",20,2001,14.2,49,24,32,13,4,29,53,54.7,24,24,4,20,15,64,45,0,"Matches","https://fbref.com/en/comps/9/defense/Premier-League-Stats"
"Ben Pearson","Bournemouth",2023,"eng ENG","MF",27,1995,3.2,7,3,3,3,1,1,3,33.3,2,4,0,4,2,9,6,0,"Matches","https://fbref.com/en/comps/9/defense/Premier-League-Stats"
"Facundo Pellistri","Manchester Utd",2023,"uy URU","FW,MF",20,2001,0.7,1,1,0,1,0,0,0,NA,0,0,0,0,0,1,3,0,"Matches","https://fbref.com/en/comps/9/defense/Premier-League-Stats"
"Andreas Pereira","Fulham",2023,"br BRA","MF",26,1996,29.9,18,9,3,6,9,8,33,24.2,25,21,3,18,6,24,8,0,"Matches","https://fbref.com/en/comps/9/defense/Premier-League-Stats"
"Ricardo Pereira","Leicester City",2023,"pt POR","DF,MF",28,1993,5,11,7,8,3,0,7,17,41.2,10,8,2,6,4,15,20,0,"Matches","https://fbref.com/en/comps/9/defense/Premier-League-Stats"
"Ayoze Pérez","Leicester City",2023,"es ESP","MF,FW",29,1993,4.2,11,8,5,4,2,8,19,42.1,11,6,0,6,2,13,3,0,"Matches","https://fbref.com/en/comps/9/defense/Premier-League-Stats"
"Ivan Periic","Tottenham",2023,"hr CRO","DF,MF",33,1989,23.4,42,24,25,10,7,27,47,57.4,20,29,7,22,22,64,49,1,"Matches","https://fbref.com/en/comps/9/defense/Premier-League-Stats"
"Romain Perraud","Southampton",2023,"fr FRA","DF",24,1997,20.4,54,33,23,23,8,28,52,53.8,24,24,6,18,20,74,42,0,"Matches","https://fbref.com/en/comps/9/defense/Premier-League-Stats"
"Máximo Perrone","Manchester City",2023,"ar ARG","MF",19,2003,0.2,0,0,0,0,0,0,0,NA,0,1,0,1,0,0,0,0,"Matches","https://fbref.com/en/comps/9/defense/Premier-League-Stats"
"Cameron Peupion","Brighton",2023,"au AUS","MF",19,2002,0.1,0,0,0,0,0,0,0,NA,0,0,0,0,0,0,0,0,"Matches","https://fbref.com/en/comps/9/defense/Premier-League-Stats"
"Kalvin Phillips","Manchester City",2023,"eng ENG","MF",26,1995,3.3,6,4,3,3,0,2,9,22.2,7,7,3,4,5,11,10,0,"Matches","https://fbref.com/en/comps/9/defense/Premier-League-Stats"
"Nathaniel Phillips","Liverpool",2023,"eng ENG","DF",25,1997,0.7,2,1,0,2,0,2,2,100,0,0,0,0,2,4,1,0,"Matches","https://fbref.com/en/comps/9/defense/Premier-League-Stats"
"Jordan Pickford","Everton",2023,"eng ENG","GK",28,1994,37,0,0,0,0,0,0,1,0,1,0,0,0,4,4,15,3,"Matches","https://fbref.com/en/comps/9/defense/Premier-League-Stats"
"Ethan Pinnock","Brentford",2023,"jm JAM","DF",29,1993,30,52,28,33,12,7,18,24,75,6,41,31,10,35,87,215,2,"Matches","https://fbref.com/en/comps/9/defense/Premier-League-Stats"
"Daniel Podence","Wolves",2023,"pt POR","FW,MF",26,1995,19.7,27,17,13,9,5,6,31,19.4,25,19,0,19,7,34,6,0,"Matches","https://fbref.com/en/comps/9/defense/Premier-League-Stats"
"Nick Pope","Newcastle Utd",2023,"eng ENG","GK",30,1992,36.2,1,0,1,0,0,1,3,33.3,2,0,0,0,0,1,27,2,"Matches","https://fbref.com/en/comps/9/defense/Premier-League-Stats"
"Pedro Porro","Tottenham",2023,"es ESP","DF,MF",22,1999,12.6,25,16,8,15,2,14,39,35.9,25,25,2,23,15,40,24,1,"Matches","https://fbref.com/en/comps/9/defense/Premier-League-Stats"
"Dennis Praet","Leicester City",2023,"be BEL","MF,FW",28,1994,7.2,12,9,5,6,1,6,11,54.5,5,12,2,10,5,17,6,0,"Matches","https://fbref.com/en/comps/9/defense/Premier-League-Stats"
"Isaac Price","Everton",2023,"nir NIR","MF",18,2003,0.4,0,0,0,0,0,0,1,0,1,1,1,0,0,0,0,0,"Matches","https://fbref.com/en/comps/9/defense/Premier-League-Stats"
"Christian Pulisic","Chelsea",2023,"us USA","FW,DF",23,1998,9.1,11,6,3,6,2,3,5,60,2,8,1,7,4,15,4,0,"Matches","https://fbref.com/en/comps/9/defense/Premier-League-Stats"
"Aaron Ramsdale","Arsenal",2023,"eng ENG","GK",24,1998,38,1,1,1,0,0,1,1,100,0,0,0,0,0,1,20,6,"Matches","https://fbref.com/en/comps/9/defense/Premier-League-Stats"
"Jacob Ramsey","Aston Villa",2023,"eng ENG","MF,FW",21,2001,29.3,69,39,23,35,11,32,69,46.4,37,48,8,40,23,92,34,0,"Matches","https://fbref.com/en/comps/9/defense/Premier-League-Stats"
"Marcus Rashford","Manchester Utd",2023,"eng ENG","FW",24,1997,32,20,10,7,8,5,9,24,37.5,15,31,4,27,7,27,14,0,"Matches","https://fbref.com/en/comps/9/defense/Premier-League-Stats"
"David Raya","Brentford",2023,"es ESP","GK",26,1995,38,0,0,0,0,0,0,2,0,2,1,0,1,1,1,10,2,"Matches","https://fbref.com/en/comps/9/defense/Premier-League-Stats"
"Tim Ream","Fulham",2023,"us USA","DF",34,1987,32.2,30,16,15,12,3,13,26,50,13,45,24,21,41,71,116,2,"Matches","https://fbref.com/en/comps/9/defense/Premier-League-Stats"
"Nathan Redmond","Southampton",2023,"eng ENG","DF",28,1994,0,0,0,0,0,0,0,0,NA,0,0,0,0,0,0,0,0,"Matches","https://fbref.com/en/comps/9/defense/Premier-League-Stats"
"Harrison Reed","Fulham",2023,"eng ENG","MF",27,1995,31.8,44,27,17,21,6,16,50,32,34,54,12,42,19,63,36,0,"Matches","https://fbref.com/en/comps/9/defense/Premier-League-Stats"
"Bobby Reid","Fulham",2023,"jm JAM","FW,DF",29,1993,27.5,42,24,14,14,14,16,34,47.1,18,25,3,22,20,62,28,1,"Matches","https://fbref.com/en/comps/9/defense/Premier-League-Stats"
"Declan Rice","West Ham",2023,"eng ENG","MF",23,1999,36.4,79,38,44,31,4,31,50,62,19,45,15,30,63,142,58,0,"Matches","https://fbref.com/en/comps/9/defense/Premier-League-Stats"
"Chris Richards","Crystal Palace",2023,"us USA","DF",22,2000,5,9,6,8,1,0,5,7,71.4,2,10,1,9,8,17,31,0,"Matches","https://fbref.com/en/comps/9/defense/Premier-League-Stats"
"Richarlison","Tottenham",2023,"br BRA","MF,FW",25,1997,11.2,21,16,13,5,3,12,27,44.4,15,14,1,13,5,26,10,0,"Matches","https://fbref.com/en/comps/9/defense/Premier-League-Stats"
"Jaïro Riedewald","Crystal Palace",2023,"nl NED","DF,MF",25,1996,0.7,2,1,2,0,0,0,1,0,1,2,0,2,0,2,4,0,"Matches","https://fbref.com/en/comps/9/defense/Premier-League-Stats"
"Matt Ritchie","Newcastle Utd",2023,"sct SCO","FW,MF",32,1989,0.4,1,1,0,1,0,1,3,33.3,2,0,0,0,1,2,0,0,"Matches","https://fbref.com/en/comps/9/defense/Premier-League-Stats"
"Andrew Robertson","Liverpool",2023,"sct SCO","DF",28,1994,28.7,38,21,12,16,10,21,41,51.2,20,32,5,27,18,56,50,3,"Matches","https://fbref.com/en/comps/9/defense/Premier-League-Stats"
"Antonee Robinson","Fulham",2023,"us USA","DF",24,1997,34.3,62,38,43,15,4,44,65,67.7,21,49,13,36,53,115,83,3,"Matches","https://fbref.com/en/comps/9/defense/Premier-League-Stats"
"Joel Robles","Leeds United",2023,"es ESP","GK",32,1990,4,0,0,0,0,0,0,1,0,1,0,0,0,0,0,2,1,"Matches","https://fbref.com/en/comps/9/defense/Premier-League-Stats"
"Marc Roca","Leeds United",2023,"es ESP","MF",25,1996,25.7,66,40,27,34,5,20,65,30.8,45,34,10,24,23,89,24,2,"Matches","https://fbref.com/en/comps/9/defense/Premier-League-Stats"
"Marek Rodák","Fulham",2023,"sk SVK","GK",25,1996,2,0,0,0,0,0,0,0,NA,0,0,0,0,0,0,1,1,"Matches","https://fbref.com/en/comps/9/defense/Premier-League-Stats"
"Rodri","Manchester City",2023,"es ESP","MF",26,1996,32.3,67,41,28,28,11,26,52,50,26,40,14,26,33,100,43,1,"Matches","https://fbref.com/en/comps/9/defense/Premier-League-Stats"
"Rodrigo","Leeds United",2023,"es ESP","FW,MF",31,1991,21.5,24,10,2,15,7,8,19,42.1,11,16,4,12,6,30,21,1,"Matches","https://fbref.com/en/comps/9/defense/Premier-League-Stats"
"Mads Roerslev","Brentford",2023,"dk DEN","DF",23,1999,12.3,22,12,19,3,0,16,33,48.5,17,14,5,9,9,31,38,0,"Matches","https://fbref.com/en/comps/9/defense/Premier-League-Stats"
"Cristian Romero","Tottenham",2023,"ar ARG","DF",24,1998,26.3,68,36,42,24,2,29,46,63,17,40,18,22,44,112,102,3,"Matches","https://fbref.com/en/comps/9/defense/Premier-League-Stats"
"Oriol Romeu","Southampton",2023,"es ESP","MF",30,1991,0.8,1,0,0,1,0,0,0,NA,0,1,0,1,1,2,1,0,"Matches","https://fbref.com/en/comps/9/defense/Premier-League-Stats"
"Cristiano Ronaldo","Manchester Utd",2023,"pt POR","FW",37,1985,5.8,2,2,1,0,1,1,2,50,1,0,0,0,1,3,9,0,"Matches","https://fbref.com/en/comps/9/defense/Premier-League-Stats"
"Connor Ronan","Wolves",2023,"ie IRL","MF",24,1998,0,0,0,0,0,0,0,0,NA,0,0,0,0,0,0,0,0,"Matches","https://fbref.com/en/comps/9/defense/Premier-League-Stats"
"Salomón Rondón","Everton",2023,"ve VEN","FW",32,1989,1.2,0,0,0,0,0,0,0,NA,0,1,1,0,0,0,0,0,"Matches","https://fbref.com/en/comps/9/defense/Premier-League-Stats"
"Joe Rothwell","Bournemouth",2023,"eng ENG","MF",27,1995,11.3,20,13,7,12,1,7,21,33.3,14,14,3,11,9,29,7,0,"Matches","https://fbref.com/en/comps/9/defense/Premier-League-Stats"
"Georginio Rutter","Leeds United",2023,"fr FRA","FW,MF",20,2002,3,10,9,5,3,2,5,8,62.5,3,5,0,5,3,13,3,0,"Matches","https://fbref.com/en/comps/9/defense/Premier-League-Stats"
"José Sá","Wolves",2023,"pt POR","GK",29,1993,36,1,0,1,0,0,1,1,100,0,0,0,0,0,1,10,6,"Matches","https://fbref.com/en/comps/9/defense/Premier-League-Stats"
"Marcel Sabitzer","Manchester Utd",2023,"at AUT","MF",28,1994,7,12,8,3,8,1,2,11,18.2,9,6,2,4,8,20,11,0,"Matches","https://fbref.com/en/comps/9/defense/Premier-League-Stats"
"Allan Saint-Maximin","Newcastle Utd",2023,"fr FRA","FW",25,1997,12.4,10,3,3,6,1,2,11,18.2,9,4,0,4,5,15,2,0,"Matches","https://fbref.com/en/comps/9/defense/Premier-League-Stats"
"Bukayo Saka","Arsenal",2023,"eng ENG","FW",20,2001,35.3,63,34,22,15,26,20,44,45.5,24,38,0,38,14,77,19,0,"Matches","https://fbref.com/en/comps/9/defense/Premier-League-Stats"
"Mohamed Salah","Liverpool",2023,"eg EGY","FW",30,1992,36.6,21,12,4,5,12,10,26,38.5,16,21,0,21,6,27,4,0,"Matches","https://fbref.com/en/comps/9/defense/Premier-League-Stats"
"William Saliba","Arsenal",2023,"fr FRA","DF",21,2001,26.8,34,20,23,9,2,15,18,83.3,3,13,10,3,19,53,85,4,"Matches","https://fbref.com/en/comps/9/defense/Premier-League-Stats"
"Mohammed Salisu","Southampton",2023,"gh GHA","DF",23,1999,21.9,51,29,33,16,2,24,34,70.6,10,56,25,31,31,82,122,1,"Matches","https://fbref.com/en/comps/9/defense/Premier-League-Stats"
"Albert Sambi Lokonga","Arsenal",2023,"be BEL","MF",22,1999,2.2,1,1,0,0,1,0,2,0,2,1,0,1,5,6,2,0,"Matches","https://fbref.com/en/comps/9/defense/Premier-League-Stats"
"Albert Sambi Lokonga","Crystal Palace",2023,"be BEL","MF",22,1999,6,13,10,7,4,2,8,12,66.7,4,8,3,5,7,20,10,0,"Matches","https://fbref.com/en/comps/9/defense/Premier-League-Stats"
"Davinson Sánchez","Tottenham",2023,"co COL","DF",26,1996,9.5,24,11,17,6,1,14,20,70,6,16,10,6,12,36,41,0,"Matches","https://fbref.com/en/comps/9/defense/Premier-League-Stats"
"Robert Sánchez","Brighton",2023,"es ESP","GK",24,1997,23,1,0,1,0,0,0,0,NA,0,0,0,0,3,4,9,2,"Matches","https://fbref.com/en/comps/9/defense/Premier-League-Stats"
"Jadon Sancho","Manchester Utd",2023,"eng ENG","FW,MF",22,2000,18.7,16,10,7,5,4,8,28,28.6,20,25,2,23,7,23,6,0,"Matches","https://fbref.com/en/comps/9/defense/Premier-League-Stats"
"Morgan Sanson","Aston Villa",2023,"fr FRA","MF",27,1994,0.1,2,1,1,1,0,1,1,100,0,0,0,0,0,2,0,0,"Matches","https://fbref.com/en/comps/9/defense/Premier-League-Stats"
"Pablo Sarabia","Wolves",2023,"es ESP","FW,MF",30,1992,8.5,12,6,4,5,3,6,15,40,9,7,0,7,2,14,4,0,"Matches","https://fbref.com/en/comps/9/defense/Premier-League-Stats"
"Jeremy Sarmiento","Brighton",2023,"ec ECU","MF",20,2002,2,6,3,4,1,1,2,5,40,3,2,0,2,1,7,0,0,"Matches","https://fbref.com/en/comps/9/defense/Premier-League-Stats"
"Gianluca Scamacca","West Ham",2023,"it ITA","FW",23,1999,10.3,10,5,1,3,6,2,2,100,0,3,0,3,4,14,5,0,"Matches","https://fbref.com/en/comps/9/defense/Premier-League-Stats"
"Gustavo Scarpa","Nott'ham Forest",2023,"br BRA","MF,FW",28,1994,2,5,2,3,1,1,2,5,40,3,4,0,4,0,5,3,0,"Matches","https://fbref.com/en/comps/9/defense/Premier-League-Stats"
"Kevin Schade","Brentford",2023,"de GER","FW",20,2001,8.1,12,8,7,2,3,5,10,50,5,7,0,7,4,16,6,0,"Matches","https://fbref.com/en/comps/9/defense/Premier-League-Stats"
"Fabian Schär","Newcastle Utd",2023,"ch SUI","DF",30,1991,35.6,47,22,31,13,3,24,39,61.5,15,34,19,15,52,99,139,0,"Matches","https://fbref.com/en/comps/9/defense/Premier-League-Stats"
"Jeffrey Schlupp","Crystal Palace",2023,"gh GHA","MF,FW",29,1992,28.1,66,46,28,29,9,22,43,51.2,21,39,8,31,23,89,38,0,"Matches","https://fbref.com/en/comps/9/defense/Premier-League-Stats"
"Nélson Semedo","Wolves",2023,"pt POR","DF",28,1993,29.2,71,42,48,19,4,33,64,51.6,31,42,15,27,29,100,83,2,"Matches","https://fbref.com/en/comps/9/defense/Premier-League-Stats"
"Antoine Semenyo","Bournemouth",2023,"gh GHA","FW,MF",22,2000,2.9,1,0,0,0,1,1,6,16.7,5,10,1,9,2,3,4,0,"Matches","https://fbref.com/en/comps/9/defense/Premier-League-Stats"
"Marcos Senesi","Bournemouth",2023,"ar ARG","DF",25,1997,27.7,50,35,28,22,0,23,43,53.5,20,38,20,18,43,93,146,2,"Matches","https://fbref.com/en/comps/9/defense/Premier-League-Stats"
"Ryan Sessegnon","Tottenham",2023,"eng ENG","DF",22,2000,9,16,11,9,7,0,6,12,50,6,8,1,7,6,22,17,1,"Matches","https://fbref.com/en/comps/9/defense/Premier-League-Stats"
"Luke Shaw","Manchester Utd",2023,"eng ENG","DF",27,1995,28.4,55,36,31,22,2,32,45,71.1,13,51,17,34,36,91,55,2,"Matches","https://fbref.com/en/comps/9/defense/Premier-League-Stats"
"Jonjo Shelvey","Newcastle Utd",2023,"eng ENG","MF",30,1992,0.4,1,0,1,0,0,0,1,0,1,1,0,1,0,1,0,0,"Matches","https://fbref.com/en/comps/9/defense/Premier-League-Stats"
"Jonjo Shelvey","Nott'ham Forest",2023,"eng ENG","MF",30,1992,6,2,1,0,1,1,1,9,11.1,8,7,2,5,5,7,10,1,"Matches","https://fbref.com/en/comps/9/defense/Premier-League-Stats"
"Bernardo Silva","Manchester City",2023,"pt POR","MF,FW",27,1994,24.5,44,23,11,25,8,18,44,40.9,26,23,6,17,16,60,6,0,"Matches","https://fbref.com/en/comps/9/defense/Premier-League-Stats"
"Thiago Silva","Chelsea",2023,"br BRA","DF",37,1984,26.1,41,27,24,17,0,21,31,67.7,10,38,29,9,34,75,111,2,"Matches","https://fbref.com/en/comps/9/defense/Premier-League-Stats"
"Ellis Simms","Everton",2023,"eng ENG","FW",21,2001,2.5,0,0,0,0,0,0,0,NA,0,0,0,0,0,0,1,0,"Matches","https://fbref.com/en/comps/9/defense/Premier-League-Stats"
"Luis Sinisterra","Leeds United",2023,"co COL","FW",23,1999,9.6,21,14,8,9,4,11,18,61.1,7,11,1,10,8,29,2,0,"Matches","https://fbref.com/en/comps/9/defense/Premier-League-Stats"
"Oliver Skipp","Tottenham",2023,"eng ENG","MF",21,2000,16.6,34,17,18,15,1,16,33,48.5,17,17,8,9,17,51,19,1,"Matches","https://fbref.com/en/comps/9/defense/Premier-League-Stats"
"Adam Smith","Bournemouth",2023,"eng ENG","DF",31,1991,32.7,49,29,27,19,3,29,60,48.3,31,30,13,17,25,74,81,1,"Matches","https://fbref.com/en/comps/9/defense/Premier-League-Stats"
"Emile Smith Rowe","Arsenal",2023,"eng ENG","MF,FW",22,2000,1.9,1,1,1,0,0,1,3,33.3,2,1,0,1,0,1,2,0,"Matches","https://fbref.com/en/comps/9/defense/Premier-League-Stats"
"Cédric Soares","Arsenal",2023,"pt POR","DF",30,1991,0.3,0,0,0,0,0,0,1,0,1,1,0,1,0,0,1,0,"Matches","https://fbref.com/en/comps/9/defense/Premier-League-Stats"
"Cédric Soares","Fulham",2023,"pt POR","DF",30,1991,2.2,8,5,4,3,1,3,3,100,0,3,1,2,1,9,5,0,"Matches","https://fbref.com/en/comps/9/defense/Premier-League-Stats"
"Dominic Solanke","Bournemouth",2023,"eng ENG","FW,MF",24,1997,31.8,15,9,8,3,4,5,22,22.7,17,26,7,19,6,21,46,0,"Matches","https://fbref.com/en/comps/9/defense/Premier-League-Stats"
"Manor Solomon","Fulham",2023,"il ISR","FW",23,1999,6.4,20,12,12,6,2,9,16,56.3,7,8,0,8,5,25,3,0,"Matches","https://fbref.com/en/comps/9/defense/Premier-League-Stats"
"Tomá Soucek","West Ham",2023,"cz CZE","MF",27,1995,31.3,77,37,41,29,7,28,58,48.3,30,42,17,25,53,130,71,3,"Matches","https://fbref.com/en/comps/9/defense/Premier-League-Stats"
"Boubakary Soumaré","Leicester City",2023,"fr FRA","MF",23,1999,18.1,57,34,29,26,2,23,43,53.5,20,15,4,11,33,90,27,1,"Matches","https://fbref.com/en/comps/9/defense/Premier-League-Stats"
"Harry Souttar","Leicester City",2023,"au AUS","DF",23,1998,11,15,9,10,5,0,7,18,38.9,11,16,12,4,12,27,45,0,"Matches","https://fbref.com/en/comps/9/defense/Premier-League-Stats"
"Çaglar Söyüncü","Leicester City",2023,"tr TUR","DF",26,1996,5.9,14,9,10,4,0,7,10,70,3,9,8,1,7,21,30,0,"Matches","https://fbref.com/en/comps/9/defense/Premier-League-Stats"
"Djed Spence","Tottenham",2023,"eng ENG","FW,DF",21,2000,0.1,0,0,0,0,0,0,0,NA,0,0,0,0,0,0,0,0,"Matches","https://fbref.com/en/comps/9/defense/Premier-League-Stats"
"Jack Stacey","Bournemouth",2023,"eng ENG","DF",26,1996,3.3,5,4,3,1,1,2,5,40,3,3,1,2,5,10,15,0,"Matches","https://fbref.com/en/comps/9/defense/Premier-League-Stats"
"Junior Stanislas","Bournemouth",2023,"eng ENG","MF",32,1989,0.7,0,0,0,0,0,0,0,NA,0,2,1,1,0,0,0,0,"Matches","https://fbref.com/en/comps/9/defense/Premier-League-Stats"
"Jay Stansfield","Fulham",2023,"eng ENG","FW",19,2002,1,0,0,0,0,0,0,2,0,2,4,1,3,1,1,1,0,"Matches","https://fbref.com/en/comps/9/defense/Premier-League-Stats"
"Jason Steele","Brighton",2023,"eng ENG","GK",31,1990,15,0,0,0,0,0,0,1,0,1,0,0,0,0,0,6,1,"Matches","https://fbref.com/en/comps/9/defense/Premier-League-Stats"
"Jack Stephens","Southampton",2023,"eng ENG","DF",28,1994,0.5,2,2,2,0,0,1,1,100,0,1,1,0,1,3,2,0,"Matches","https://fbref.com/en/comps/9/defense/Premier-League-Stats"
"Jack Stephens","Bournemouth",2023,"eng ENG","DF",28,1994,13,15,11,10,4,1,6,10,60,4,23,16,7,16,31,53,0,"Matches","https://fbref.com/en/comps/9/defense/Premier-League-Stats"
"Raheem Sterling","Chelsea",2023,"eng ENG","FW,MF",27,1994,21,18,10,5,4,9,8,14,57.1,6,17,0,17,2,20,5,0,"Matches","https://fbref.com/en/comps/9/defense/Premier-League-Stats"
"John Stones","Manchester City",2023,"eng ENG","DF,MF",28,1994,20.5,23,13,11,8,4,7,10,70,3,17,10,7,9,32,40,0,"Matches","https://fbref.com/en/comps/9/defense/Premier-League-Stats"
"Pascal Struijk","Leeds United",2023,"nl NED","DF",22,1999,24.4,84,57,43,31,10,49,75,65.3,26,32,12,20,32,116,70,1,"Matches","https://fbref.com/en/comps/9/defense/Premier-League-Stats"
"Kamaldeen Sulemana","Southampton",2023,"gh GHA","FW,MF",20,2002,10.7,15,9,4,7,4,4,14,28.6,10,16,0,16,6,21,6,0,"Matches","https://fbref.com/en/comps/9/defense/Premier-League-Stats"
"Crysencio Summerville","Leeds United",2023,"nl NED","FW",20,2001,15.8,30,20,14,14,2,11,23,47.8,12,20,2,18,13,43,11,0,"Matches","https://fbref.com/en/comps/9/defense/Premier-League-Stats"
"Sam Surridge","Nott'ham Forest",2023,"eng ENG","FW",24,1998,3.6,5,0,1,3,1,1,4,25,3,5,2,3,0,5,7,0,"Matches","https://fbref.com/en/comps/9/defense/Premier-League-Stats"
"Japhet Tanganga","Tottenham",2023,"eng ENG","DF",23,1999,1.6,3,2,3,0,0,1,5,20,4,1,0,1,2,5,8,0,"Matches","https://fbref.com/en/comps/9/defense/Premier-League-Stats"
"Matt Targett","Newcastle Utd",2023,"eng ENG","DF",26,1995,6.8,13,10,8,3,2,9,24,37.5,15,8,3,5,9,22,16,0,"Matches","https://fbref.com/en/comps/9/defense/Premier-League-Stats"
"James Tarkowski","Everton",2023,"eng ENG","DF",29,1992,38,51,26,36,13,2,20,38,52.6,18,99,78,21,51,102,201,3,"Matches","https://fbref.com/en/comps/9/defense/Premier-League-Stats"
"Marcus Tavernier","Bournemouth",2023,"eng ENG","MF,FW",23,1999,19.4,33,22,19,11,3,11,32,34.4,21,25,4,21,9,42,23,0,"Matches","https://fbref.com/en/comps/9/defense/Premier-League-Stats"
"Tetê","Leicester City",2023,"br BRA","FW",22,2000,8.2,14,8,5,7,2,6,21,28.6,15,9,0,9,2,16,3,0,"Matches","https://fbref.com/en/comps/9/defense/Premier-League-Stats"
"Kenny Tete","Fulham",2023,"nl NED","DF",26,1995,28.5,83,46,41,29,13,38,50,76,12,48,17,31,52,135,81,1,"Matches","https://fbref.com/en/comps/9/defense/Premier-League-Stats"
"Luke Thomas","Leicester City",2023,"eng ENG","DF",21,2001,11.9,23,19,15,5,3,15,32,46.9,17,20,4,16,27,50,35,0,"Matches","https://fbref.com/en/comps/9/defense/Premier-League-Stats"
"Youri Tielemans","Leicester City",2023,"be BEL","MF",25,1997,26,66,39,27,30,9,23,61,37.7,38,35,8,27,28,94,24,1,"Matches","https://fbref.com/en/comps/9/defense/Premier-League-Stats"
"Kieran Tierney","Arsenal",2023,"sct SCO","DF",25,1997,8.8,20,11,9,9,2,12,16,75,4,8,2,6,11,31,25,0,"Matches","https://fbref.com/en/comps/9/defense/Premier-League-Stats"
"Harry Toffolo","Nott'ham Forest",2023,"eng ENG","DF",26,1995,10.4,17,8,10,4,3,10,14,71.4,4,16,8,8,10,27,33,0,"Matches","https://fbref.com/en/comps/9/defense/Premier-League-Stats"
"Takehiro Tomiyasu","Arsenal",2023,"jp JPN","DF",23,1998,7.4,27,18,12,10,5,13,18,72.2,5,7,0,7,14,41,15,1,"Matches","https://fbref.com/en/comps/9/defense/Premier-League-Stats"
"James Tomkins","Crystal Palace",2023,"eng ENG","DF",33,1989,3.8,4,2,2,1,1,1,3,33.3,2,3,2,1,5,9,19,0,"Matches","https://fbref.com/en/comps/9/defense/Premier-League-Stats"
"Ivan Toney","Brentford",2023,"eng ENG","FW",26,1996,32.8,23,13,4,9,10,7,23,30.4,16,24,9,15,14,37,36,0,"Matches","https://fbref.com/en/comps/9/defense/Premier-League-Stats"
"Adama Traoré","Wolves",2023,"es ESP","FW,MF",26,1996,16.6,14,7,7,4,3,4,9,44.4,5,8,1,7,3,17,17,0,"Matches","https://fbref.com/en/comps/9/defense/Premier-League-Stats"
"Bertrand Traoré","Aston Villa",2023,"bf BFA","FW,MF",26,1995,2.6,1,1,1,0,0,1,4,25,3,5,0,5,2,3,0,0,"Matches","https://fbref.com/en/comps/9/defense/Premier-League-Stats"
"Boubacar Traoré","Wolves",2023,"ml MLI","MF",20,2001,4.6,12,5,4,5,3,3,7,42.9,4,4,2,2,7,19,1,0,"Matches","https://fbref.com/en/comps/9/defense/Premier-League-Stats"
"Mark Travers","Bournemouth",2023,"ie IRL","GK",23,1999,11.5,0,0,0,0,0,0,0,NA,0,1,0,1,0,0,6,0,"Matches","https://fbref.com/en/comps/9/defense/Premier-League-Stats"
"Kieran Trippier","Newcastle Utd",2023,"eng ENG","DF",31,1990,37.1,71,49,36,27,8,46,90,51.1,44,45,15,30,43,114,84,2,"Matches","https://fbref.com/en/comps/9/defense/Premier-League-Stats"
"Leandro Trossard","Arsenal",2023,"be BEL","FW",27,1994,10.3,12,7,4,2,6,6,18,33.3,12,18,0,18,6,18,3,1,"Matches","https://fbref.com/en/comps/9/defense/Premier-League-Stats"
"Leandro Trossard","Brighton",2023,"be BEL","FW,MF",27,1994,14.6,10,6,7,1,2,1,8,12.5,7,17,0,17,6,16,1,0,"Matches","https://fbref.com/en/comps/9/defense/Premier-League-Stats"
"Kostas Tsimikas","Liverpool",2023,"gr GRE","DF",26,1996,8.6,14,9,10,2,2,10,16,62.5,6,8,1,7,12,26,15,0,"Matches","https://fbref.com/en/comps/9/defense/Premier-League-Stats"
"Deniz Undav","Brighton",2023,"de GER","FW,MF",26,1996,7,7,4,2,2,3,2,8,25,6,4,1,3,0,7,1,0,"Matches","https://fbref.com/en/comps/9/defense/Premier-League-Stats"
"Yan Valery","Southampton",2023,"tn TUN","DF",23,1999,0.5,0,0,0,0,0,0,0,NA,0,1,0,1,0,0,3,0,"Matches","https://fbref.com/en/comps/9/defense/Premier-League-Stats"
"Virgil van Dijk","Liverpool",2023,"nl NED","DF",31,1991,31.5,27,14,13,11,3,8,19,42.1,11,24,16,8,31,58,138,2,"Matches","https://fbref.com/en/comps/9/defense/Premier-League-Stats"
"Raphaël Varane","Manchester Utd",2023,"fr FRA","DF",29,1993,21.2,24,9,18,6,0,7,17,41.2,10,24,17,7,11,35,91,0,"Matches","https://fbref.com/en/comps/9/defense/Premier-League-Stats"
"Jamie Vardy","Leicester City",2023,"eng ENG","FW",35,1987,20.6,10,5,4,3,3,1,7,14.3,6,17,3,14,2,12,30,0,"Matches","https://fbref.com/en/comps/9/defense/Premier-League-Stats"
"Joël Veltman","Brighton",2023,"nl NED","DF",30,1992,24.3,62,32,44,14,4,37,57,64.9,20,27,8,19,19,81,51,0,"Matches","https://fbref.com/en/comps/9/defense/Premier-League-Stats"
"Fabio Vieira","Arsenal",2023,"pt POR","MF,FW",22,2000,5.7,6,4,3,0,3,3,5,60,2,5,0,5,4,10,2,0,"Matches","https://fbref.com/en/comps/9/defense/Premier-League-Stats"
"Matías Viña","Bournemouth",2023,"uy URU","DF",24,1997,5.1,19,11,9,8,2,14,30,46.7,16,13,1,12,4,23,22,0,"Matches","https://fbref.com/en/comps/9/defense/Premier-League-Stats"
"Rúben Vinagre","Everton",2023,"pt POR","DF,MF",23,1999,0.3,2,2,1,1,0,1,2,50,1,0,0,0,0,2,1,0,"Matches","https://fbref.com/en/comps/9/defense/Premier-League-Stats"
"Carlos Vinícius","Fulham",2023,"br BRA","FW",27,1995,12.3,4,1,0,2,2,0,4,0,4,7,0,7,0,4,10,0,"Matches","https://fbref.com/en/comps/9/defense/Premier-League-Stats"
"Theo Walcott","Southampton",2023,"eng ENG","FW,MF",33,1989,12.5,13,6,8,4,1,8,27,29.6,19,8,1,7,9,22,7,0,"Matches","https://fbref.com/en/comps/9/defense/Premier-League-Stats"
"Kyle Walker","Manchester City",2023,"eng ENG","DF",32,1990,21.8,13,9,8,5,0,4,24,16.7,20,12,2,10,18,31,22,0,"Matches","https://fbref.com/en/comps/9/defense/Premier-League-Stats"
"Kyle Walker-Peters","Southampton",2023,"eng ENG","DF",25,1997,29.4,61,32,34,24,3,22,42,52.4,20,47,8,39,27,88,52,0,"Matches","https://fbref.com/en/comps/9/defense/Premier-League-Stats"
"Aaron Wan-Bissaka","Manchester Utd",2023,"eng ENG","DF",24,1997,15.9,40,25,20,17,3,23,25,92,2,24,8,16,22,62,41,0,"Matches","https://fbref.com/en/comps/9/defense/Premier-League-Stats"
"Danny Ward","Leicester City",2023,"wls WAL","GK",29,1993,26,1,1,1,0,0,1,3,33.3,2,0,0,0,0,1,14,2,"Matches","https://fbref.com/en/comps/9/defense/Premier-League-Stats"
"Joel Ward","Crystal Palace",2023,"eng ENG","DF",32,1989,25.1,50,36,30,11,9,30,41,73.2,11,32,16,16,25,75,80,1,"Matches","https://fbref.com/en/comps/9/defense/Premier-League-Stats"
"James Ward-Prowse","Southampton",2023,"eng ENG","MF",27,1994,37.5,65,37,31,27,7,21,61,34.4,40,30,10,20,55,120,48,0,"Matches","https://fbref.com/en/comps/9/defense/Premier-League-Stats"
"Ollie Watkins","Aston Villa",2023,"eng ENG","FW",26,1995,34.7,19,13,3,13,3,10,27,37,17,21,4,17,10,29,39,0,"Matches","https://fbref.com/en/comps/9/defense/Premier-League-Stats"
"Adam Webster","Brighton",2023,"eng ENG","DF",27,1995,22.1,22,12,10,9,3,11,19,57.9,8,30,19,11,19,41,55,4,"Matches","https://fbref.com/en/comps/9/defense/Premier-League-Stats"
"Wout Weghorst","Manchester Utd",2023,"nl NED","FW,MF",29,1992,8.9,11,5,6,1,4,2,9,22.2,7,7,2,5,7,18,9,0,"Matches","https://fbref.com/en/comps/9/defense/Premier-League-Stats"
"Danny Welbeck","Brighton",2023,"eng ENG","FW",31,1990,20.6,15,7,0,7,8,4,11,36.4,7,24,2,22,5,20,20,0,"Matches","https://fbref.com/en/comps/9/defense/Premier-League-Stats"
"Ben White","Arsenal",2023,"eng ENG","DF",24,1997,33.9,60,31,23,30,7,42,70,60,28,47,11,36,22,82,79,1,"Matches","https://fbref.com/en/comps/9/defense/Premier-League-Stats"
"Harvey White","Tottenham",2023,"eng ENG","MF",20,2001,0.1,0,0,0,0,0,0,1,0,1,0,0,0,0,0,0,0,"Matches","https://fbref.com/en/comps/9/defense/Premier-League-Stats"
"Joseph Whitworth","Crystal Palace",2023,"eng ENG","GK",18,2004,2,0,0,0,0,0,0,0,NA,0,0,0,0,0,0,1,0,"Matches","https://fbref.com/en/comps/9/defense/Premier-League-Stats"
"Neco Williams","Nott'ham Forest",2023,"wls WAL","DF",21,2001,20.9,72,47,49,17,6,38,71,53.5,33,33,8,25,33,105,48,0,"Matches","https://fbref.com/en/comps/9/defense/Premier-League-Stats"
"Willian","Fulham",2023,"br BRA","FW",33,1988,23.6,13,8,8,3,2,7,25,28,18,13,0,13,9,22,9,0,"Matches","https://fbref.com/en/comps/9/defense/Premier-League-Stats"
"Joe Willock","Newcastle Utd",2023,"eng ENG","MF",22,1999,28.4,51,30,13,26,12,25,58,43.1,33,54,8,46,25,76,17,0,"Matches","https://fbref.com/en/comps/9/defense/Premier-League-Stats"
"Callum Wilson","Newcastle Utd",2023,"eng ENG","FW",30,1992,20.9,9,3,0,8,1,0,3,0,3,8,0,8,1,10,5,0,"Matches","https://fbref.com/en/comps/9/defense/Premier-League-Stats"
"Harry Wilson","Fulham",2023,"wls WAL","FW",25,1997,12.2,21,13,9,9,3,8,18,44.4,10,17,2,15,6,27,14,0,"Matches","https://fbref.com/en/comps/9/defense/Premier-League-Stats"
"Yoane Wissa","Brentford",2023,"cd COD","FW",25,1996,17.8,17,12,4,7,6,6,13,46.2,7,10,0,10,6,23,15,0,"Matches","https://fbref.com/en/comps/9/defense/Premier-League-Stats"
"Maximilian Wöber","Leeds United",2023,"at AUT","DF",24,1998,14.1,25,18,9,15,1,16,24,66.7,8,32,14,18,27,52,67,1,"Matches","https://fbref.com/en/comps/9/defense/Premier-League-Stats"
"Chris Wood","Newcastle Utd",2023,"nz NZL","FW",30,1991,5,5,4,0,3,2,3,5,60,2,2,2,0,1,6,7,0,"Matches","https://fbref.com/en/comps/9/defense/Premier-League-Stats"
"Chris Wood","Nott'ham Forest",2023,"nz NZL","FW",30,1991,4.1,0,0,0,0,0,0,1,0,1,2,1,1,1,1,2,0,"Matches","https://fbref.com/en/comps/9/defense/Premier-League-Stats"
"Joe Worrall","Nott'ham Forest",2023,"eng ENG","DF",25,1997,24.7,53,25,39,12,2,25,35,71.4,10,33,23,10,26,79,111,1,"Matches","https://fbref.com/en/comps/9/defense/Premier-League-Stats"
"Granit Xhaka","Arsenal",2023,"ch SUI","MF",29,1992,33.3,34,27,11,18,5,16,41,39,25,28,10,18,15,49,45,1,"Matches","https://fbref.com/en/comps/9/defense/Premier-League-Stats"
"Ryan Yates","Nott'ham Forest",2023,"eng ENG","MF",24,1997,20.4,38,19,19,16,3,14,22,63.6,8,26,8,18,10,48,44,0,"Matches","https://fbref.com/en/comps/9/defense/Premier-League-Stats"
"Ashley Young","Aston Villa",2023,"eng ENG","DF",37,1985,22.6,50,27,34,15,1,37,49,75.5,12,25,11,14,21,71,65,0,"Matches","https://fbref.com/en/comps/9/defense/Premier-League-Stats"
"Illia Zabarnyi","Bournemouth",2023,"ua UKR","DF",19,2002,3.3,4,2,4,0,0,3,7,42.9,4,7,2,5,3,7,14,0,"Matches","https://fbref.com/en/comps/9/defense/Premier-League-Stats"
"Wilfried Zaha","Crystal Palace",2023,"ci CIV","FW,MF",29,1992,25.4,32,20,12,12,8,8,21,38.1,13,21,1,20,16,48,9,0,"Matches","https://fbref.com/en/comps/9/defense/Premier-League-Stats"
"Denis Zakaria","Chelsea",2023,"ch SUI","MF",25,1996,4.6,9,5,5,2,2,2,8,25,6,4,1,3,3,12,10,0,"Matches","https://fbref.com/en/comps/9/defense/Premier-League-Stats"
"Jordan Zemura","Bournemouth",2023,"zw ZIM","DF",22,1999,16.2,39,24,24,14,1,23,43,53.5,20,31,9,22,16,55,32,0,"Matches","https://fbref.com/en/comps/9/defense/Premier-League-Stats"
"Oleksandr Zinchenko","Arsenal",2023,"ua UKR","DF",25,1996,23.5,40,18,14,17,9,21,39,53.8,18,20,2,18,22,62,38,2,"Matches","https://fbref.com/en/comps/9/defense/Premier-League-Stats"
"Hakim Ziyech","Chelsea",2023,"ma MAR","FW,MF",29,1993,7.3,20,12,12,5,3,4,9,44.4,5,8,0,8,5,25,5,1,"Matches","https://fbref.com/en/comps/9/defense/Premier-League-Stats"
"Kurt Zouma","West Ham",2023,"fr FRA","DF",27,1994,22.1,9,4,4,5,0,5,8,62.5,3,17,14,3,30,39,120,1,"Matches","https://fbref.com/en/comps/9/defense/Premier-League-Stats"
"Martin Ødegaard","Arsenal",2023,"no NOR","MF",23,1998,34.7,36,23,12,14,10,14,47,29.8,33,20,5,15,6,42,12,1,"Matches","https://fbref.com/en/comps/9/defense/Premier-League-Stats"
